"","Geography","year","population","prev_year","population_diff","percent_different"
"1","Appling",2000,17396,17323,73,0.421405068406165
"2","Appling",2001,17455,17396,59,0.339158427224649
"3","Appling",2002,17502,17455,47,0.269263821254655
"4","Appling",2003,17732,17502,230,1.3141355273683
"5","Appling",2004,17740,17732,8,0.0451161741484322
"6","Appling",2005,17769,17740,29,0.163472378804961
"7","Appling",2006,17725,17769,-44,-0.247622263492599
"8","Appling",2007,17985,17725,260,1.46685472496474
"9","Appling",2008,18133,17985,148,0.822907978871282
"10","Appling",2009,18144,18133,11,0.0606628798323499
"11","Appling",2010,18261,18144,117,0.64484126984127
"12","Appling",2011,18420,18261,159,0.870708066370954
"13","Appling",2012,18368,18420,-52,-0.282301845819761
"14","Appling",2013,18440,18368,72,0.39198606271777
"15","Appling",2014,18540,18440,100,0.542299349240781
"16","Appling",2015,18454,18540,-86,-0.4638619201726
"17","Appling",2016,18428,18454,-26,-0.140890863769373
"18","Appling",2017,18521,18428,93,0.504666811373996
"19","Appling",2018,18507,18521,-14,-0.0755898709572917
"20","Appling",2019,18386,18507,-121,-0.653806667747339
"21","Appling",2020,18325,18386,-61,-0.331774176003481
"22","Appling",2021,18488,18325,163,0.889495225102319
"23","Appling",2022,18428,18488,-60,-0.324534833405452
"24","Atkinson",2000,7591,7575,16,0.211221122112211
"25","Atkinson",2001,7641,7591,50,0.658674746410223
"26","Atkinson",2002,7748,7641,107,1.40034026959822
"27","Atkinson",2003,7990,7748,242,3.12338668043366
"28","Atkinson",2004,7985,7990,-5,-0.0625782227784731
"29","Atkinson",2005,8096,7985,111,1.39010644959299
"30","Atkinson",2006,8197,8096,101,1.24752964426877
"31","Atkinson",2007,8346,8197,149,1.81773819690131
"32","Atkinson",2008,8366,8346,20,0.239635753654445
"33","Atkinson",2009,8386,8366,20,0.23906287353574
"34","Atkinson",2010,8366,8386,-20,-0.238492725971858
"35","Atkinson",2011,8413,8366,47,0.561797752808989
"36","Atkinson",2012,8284,8413,-129,-1.53334125757756
"37","Atkinson",2013,8290,8284,6,0.0724287783679382
"38","Atkinson",2014,8223,8290,-67,-0.808202653799759
"39","Atkinson",2015,8398,8223,175,2.12817706433175
"40","Atkinson",2016,8273,8398,-125,-1.48844963086449
"41","Atkinson",2017,8342,8273,69,0.834038438293243
"42","Atkinson",2018,8297,8342,-45,-0.539438983457205
"43","Atkinson",2019,8165,8297,-132,-1.59093648306617
"44","Atkinson",2020,8393,8165,228,2.79240661359461
"45","Atkinson",2021,8391,8393,-2,-0.0238293816275468
"46","Atkinson",2022,8183,8391,-208,-2.47884638302944
"47","Bacon",2000,10131,10053,78,0.775887794688153
"48","Bacon",2001,10133,10131,2,0.0197413878195637
"49","Bacon",2002,10101,10133,-32,-0.31579986183756
"50","Bacon",2003,10253,10101,152,1.5048015048015
"51","Bacon",2004,10283,10253,30,0.292597288598459
"52","Bacon",2005,10552,10283,269,2.61596810269377
"53","Bacon",2006,10682,10552,130,1.23199393479909
"54","Bacon",2007,10968,10682,286,2.67740123572365
"55","Bacon",2008,10987,10968,19,0.173231218088986
"56","Bacon",2009,11134,10987,147,1.33794484390643
"57","Bacon",2010,11076,11134,-58,-0.520926890605353
"58","Bacon",2011,11203,11076,127,1.14662332972192
"59","Bacon",2012,11198,11203,-5,-0.0446309024368473
"60","Bacon",2013,11216,11198,18,0.160742989819611
"61","Bacon",2014,11281,11216,65,0.579529243937233
"62","Bacon",2015,11299,11281,18,0.15956032266643
"63","Bacon",2016,11372,11299,73,0.646074873882645
"64","Bacon",2017,11319,11372,-53,-0.466056982061203
"65","Bacon",2018,11185,11319,-134,-1.183850163442
"66","Bacon",2019,11164,11185,-21,-0.187751452838623
"67","Bacon",2020,11036,11164,-128,-1.14654245790039
"68","Bacon",2021,11079,11036,43,0.389633925335266
"69","Bacon",2022,11191,11079,112,1.01092156331799
"70","Baker",2000,4025,4089,-64,-1.56517485937882
"71","Baker",2001,4005,4025,-20,-0.496894409937888
"72","Baker",2002,3923,4005,-82,-2.04744069912609
"73","Baker",2003,4124,3923,201,5.12362987509559
"74","Baker",2004,4024,4124,-100,-2.42483026188167
"75","Baker",2005,3967,4024,-57,-1.41650099403579
"76","Baker",2006,3877,3967,-90,-2.268716914545
"77","Baker",2007,3706,3877,-171,-4.41062677327831
"78","Baker",2008,3728,3706,22,0.593631948192121
"79","Baker",2009,3560,3728,-168,-4.50643776824034
"80","Baker",2010,3415,3560,-145,-4.07303370786517
"81","Baker",2011,3085,3415,-330,-9.66325036603221
"82","Baker",2012,3366,3085,281,9.10858995137763
"83","Baker",2013,3341,3366,-25,-0.742721330956625
"84","Baker",2014,3255,3341,-86,-2.57407961688117
"85","Baker",2015,3180,3255,-75,-2.30414746543779
"86","Baker",2016,3150,3180,-30,-0.943396226415094
"87","Baker",2017,3200,3150,50,1.58730158730159
"88","Baker",2018,3092,3200,-108,-3.375
"89","Baker",2019,3038,3092,-54,-1.74644243208279
"90","Baker",2020,2971,3038,-67,-2.2053982883476
"91","Baker",2021,2819,2971,-152,-5.11612251767082
"92","Baker",2022,2788,2819,-31,-1.0996807378503
"93","Baldwin",2000,44684,44440,244,0.549054905490549
"94","Baldwin",2001,44764,44684,80,0.179035001342763
"95","Baldwin",2002,45203,44764,439,0.980698775801984
"96","Baldwin",2003,45433,45203,230,0.508815786562839
"97","Baldwin",2004,45967,45433,534,1.17535711927454
"98","Baldwin",2005,46304,45967,337,0.733134640067875
"99","Baldwin",2006,46513,46304,209,0.451364892881824
"100","Baldwin",2007,47336,46513,823,1.76939780276482
"101","Baldwin",2008,47855,47336,519,1.09641710326179
"102","Baldwin",2009,47087,47855,-768,-1.60484797826768
"103","Baldwin",2010,45735,47087,-1352,-2.87128082060866
"104","Baldwin",2011,44417,45735,-1318,-2.88181917568602
"105","Baldwin",2012,46367,44417,1950,4.39021095526488
"106","Baldwin",2013,46039,46367,-328,-0.707399659240408
"107","Baldwin",2014,45909,46039,-130,-0.282369295597211
"108","Baldwin",2015,45459,45909,-450,-0.980199960792002
"109","Baldwin",2016,45144,45459,-315,-0.69293209265492
"110","Baldwin",2017,44906,45144,-238,-0.527201842991317
"111","Baldwin",2018,44823,44906,-83,-0.184830534895114
"112","Baldwin",2019,44890,44823,67,0.149476831091181
"113","Baldwin",2020,45099,44890,209,0.465582535085765
"114","Baldwin",2021,43781,45099,-1318,-2.92245947803721
"115","Baldwin",2022,43635,43781,-146,-0.333477992736575
"116","Banks",2000,14544,14037,507,3.61188288095747
"117","Banks",2001,15025,14544,481,3.30720572057206
"118","Banks",2002,15485,15025,460,3.06156405990017
"119","Banks",2003,15836,15485,351,2.26670971908298
"120","Banks",2004,16250,15836,414,2.61429653953018
"121","Banks",2005,16683,16250,433,2.66461538461538
"122","Banks",2006,17076,16683,393,2.35569142240604
"123","Banks",2007,17550,17076,474,2.77582572030921
"124","Banks",2008,17953,17550,403,2.2962962962963
"125","Banks",2009,18208,17953,255,1.4203754247201
"126","Banks",2010,18415,18208,207,1.13686291739895
"127","Banks",2011,18251,18415,-164,-0.890578332880804
"128","Banks",2012,18316,18251,65,0.356144868774314
"129","Banks",2013,18415,18316,99,0.540511028608867
"130","Banks",2014,18295,18415,-120,-0.65164268259571
"131","Banks",2015,18495,18295,200,1.09319486198415
"132","Banks",2016,18397,18495,-98,-0.529872938632063
"133","Banks",2017,18634,18397,237,1.28825351959559
"134","Banks",2018,18988,18634,354,1.89975313942256
"135","Banks",2019,19234,18988,246,1.29555508742364
"136","Banks",2020,19352,19234,118,0.613496932515337
"137","Banks",2021,18562,19352,-790,-4.08226539892518
"138","Banks",2022,19328,18562,766,4.12671048378408
"139","Barrow",2000,46520,44615,1905,4.26986439538272
"140","Barrow",2001,48171,46520,1651,3.54901117798796
"141","Barrow",2002,50409,48171,2238,4.64594880737373
"142","Barrow",2003,52253,50409,1844,3.65807693070682
"143","Barrow",2004,55032,52253,2779,5.31835492698984
"144","Barrow",2005,57889,55032,2857,5.19152493094927
"145","Barrow",2006,61395,57889,3506,6.05641831781513
"146","Barrow",2007,64760,61395,3365,5.48090235361186
"147","Barrow",2008,67362,64760,2602,4.01791229153799
"148","Barrow",2009,68548,67362,1186,1.76063656067219
"149","Barrow",2010,69731,68548,1183,1.72579798097683
"150","Barrow",2011,69912,69731,181,0.259568914829846
"151","Barrow",2012,70169,69912,257,0.367604989129191
"152","Barrow",2013,71453,70169,1284,1.82986789037894
"153","Barrow",2014,73240,71453,1787,2.50094467692049
"154","Barrow",2015,75370,73240,2130,2.90824685963954
"155","Barrow",2016,77126,75370,1756,2.32983945867056
"156","Barrow",2017,79061,77126,1935,2.50888157041724
"157","Barrow",2018,80809,79061,1748,2.21095103780625
"158","Barrow",2019,83240,80809,2431,3.00832828026581
"159","Barrow",2020,85588,83240,2348,2.8207592503604
"160","Barrow",2021,86658,85588,1070,1.25017525821377
"161","Barrow",2022,89299,86658,2641,3.04761245355305
"162","Bartow",2000,76806,74128,2678,3.61266997625729
"163","Bartow",2001,79984,76806,3178,4.13769757571023
"164","Bartow",2002,83106,79984,3122,3.90328065613123
"165","Bartow",2003,85731,83106,2625,3.15861670637499
"166","Bartow",2004,87834,85731,2103,2.45302166077615
"167","Bartow",2005,90334,87834,2500,2.84627820661703
"168","Bartow",2006,92983,90334,2649,2.93245068302079
"169","Bartow",2007,95714,92983,2731,2.93709602830625
"170","Bartow",2008,98415,95714,2701,2.82194872223499
"171","Bartow",2009,99807,98415,1392,1.4144185337601
"172","Bartow",2010,100195,99807,388,0.388750288055948
"173","Bartow",2011,100421,100195,226,0.2255601576925
"174","Bartow",2012,100661,100421,240,0.238993835950648
"175","Bartow",2013,101273,100661,612,0.60798124397731
"176","Bartow",2014,101736,101273,463,0.4571800973606
"177","Bartow",2015,102747,101736,1011,0.993748525595659
"178","Bartow",2016,103807,102747,1060,1.03166029178467
"179","Bartow",2017,105054,103807,1247,1.20126773724315
"180","Bartow",2018,106408,105054,1354,1.28886096674091
"181","Bartow",2019,107738,106408,1330,1.2499060221036
"182","Bartow",2020,109426,107738,1688,1.56676381592382
"183","Bartow",2021,110843,109426,1417,1.29493904556504
"184","Bartow",2022,112816,110843,1973,1.77999512824445
"185","Ben Hill",2000,17483,17516,-33,-0.188399177894496
"186","Ben Hill",2001,17315,17483,-168,-0.960933478236001
"187","Ben Hill",2002,17178,17315,-137,-0.7912214842622
"188","Ben Hill",2003,17095,17178,-83,-0.483176155547794
"189","Ben Hill",2004,17106,17095,11,0.0643463000877449
"190","Ben Hill",2005,17243,17106,137,0.800888577107448
"191","Ben Hill",2006,17525,17243,282,1.6354462680508
"192","Ben Hill",2007,17719,17525,194,1.10699001426534
"193","Ben Hill",2008,17675,17719,-44,-0.248321011343755
"194","Ben Hill",2009,17581,17675,-94,-0.531824611032532
"195","Ben Hill",2010,17653,17581,72,0.409533018599625
"196","Ben Hill",2011,17673,17653,20,0.113295190619158
"197","Ben Hill",2012,17538,17673,-135,-0.763877100662027
"198","Ben Hill",2013,17515,17538,-23,-0.131143802029878
"199","Ben Hill",2014,17464,17515,-51,-0.291178989437625
"200","Ben Hill",2015,17403,17464,-61,-0.349289967934036
"201","Ben Hill",2016,17243,17403,-160,-0.919381715796127
"202","Ben Hill",2017,16996,17243,-247,-1.43246534825726
"203","Ben Hill",2018,16787,16996,-209,-1.22970110614262
"204","Ben Hill",2019,16700,16787,-87,-0.5182581759695
"205","Ben Hill",2020,16614,16700,-86,-0.514970059880239
"206","Ben Hill",2021,17158,16614,544,3.27434693631877
"207","Ben Hill",2022,17069,17158,-89,-0.51870847418114
"208","Berrien",2000,16268,16086,182,1.13141862489121
"209","Berrien",2001,16392,16268,124,0.762232603884928
"210","Berrien",2002,16671,16392,279,1.70204978038067
"211","Berrien",2003,17017,16671,346,2.07546038030112
"212","Berrien",2004,17399,17017,382,2.24481400951989
"213","Berrien",2005,17735,17399,336,1.93114546813035
"214","Berrien",2006,18051,17735,316,1.7817874259938
"215","Berrien",2007,18255,18051,204,1.13013129466512
"216","Berrien",2008,18863,18255,608,3.33059435771022
"217","Berrien",2009,19067,18863,204,1.08148226687165
"218","Berrien",2010,19303,19067,236,1.23774059894058
"219","Berrien",2011,19372,19303,69,0.357457390042998
"220","Berrien",2012,19041,19372,-331,-1.70865166219286
"221","Berrien",2013,19048,19041,7,0.0367627750643349
"222","Berrien",2014,18700,19048,-348,-1.82696346073079
"223","Berrien",2015,18963,18700,263,1.40641711229947
"224","Berrien",2016,18993,18963,30,0.158202816010125
"225","Berrien",2017,19186,18993,193,1.01616384983941
"226","Berrien",2018,19252,19186,66,0.344000833941416
"227","Berrien",2019,19397,19252,145,0.753168501973821
"228","Berrien",2020,19408,19397,11,0.056709800484611
"229","Berrien",2021,18147,19408,-1261,-6.49732069249794
"230","Berrien",2022,18214,18147,67,0.369207031465256
"231","Bibb",2000,153857,154254,-397,-0.257367718179107
"232","Bibb",2001,153548,153857,-309,-0.200835841073204
"233","Bibb",2002,153929,153548,381,0.248130877640868
"234","Bibb",2003,153697,153929,-232,-0.150718837905788
"235","Bibb",2004,154159,153697,462,0.300591423384972
"236","Bibb",2005,154003,154159,-156,-0.101194221550477
"237","Bibb",2006,154510,154003,507,0.32921436595391
"238","Bibb",2007,154286,154510,-224,-0.14497443531163
"239","Bibb",2008,154384,154286,98,0.0635184008918502
"240","Bibb",2009,155154,154384,770,0.498756347808063
"241","Bibb",2010,155715,155154,561,0.361576240380525
"242","Bibb",2011,156433,155715,718,0.461098802299072
"243","Bibb",2012,156462,156433,29,0.0185382879571446
"244","Bibb",2013,154721,156462,-1741,-1.11273024760006
"245","Bibb",2014,153905,154721,-816,-0.52740093458548
"246","Bibb",2015,153721,153905,-184,-0.119554270491537
"247","Bibb",2016,152760,153721,-961,-0.625158566493843
"248","Bibb",2017,152862,152760,102,0.0667714061272584
"249","Bibb",2018,153095,152862,233,0.152425063128835
"250","Bibb",2019,153159,153095,64,0.0418041085600444
"251","Bibb",2020,152737,153159,-422,-0.275530657682539
"252","Bibb",2021,156762,152737,4025,2.63524882641403
"253","Bibb",2022,156197,156762,-565,-0.36041897908932
"254","Bleckley",2000,11654,11573,81,0.699904951179469
"255","Bleckley",2001,11781,11654,127,1.08975459069847
"256","Bleckley",2002,11757,11781,-24,-0.203717850776674
"257","Bleckley",2003,11807,11757,50,0.425278557455133
"258","Bleckley",2004,12018,11807,211,1.78707546370797
"259","Bleckley",2005,12127,12018,109,0.9069728740223
"260","Bleckley",2006,12553,12127,426,3.51282262719551
"261","Bleckley",2007,13016,12553,463,3.68836134788497
"262","Bleckley",2008,12985,13016,-31,-0.238168408113092
"263","Bleckley",2009,13034,12985,49,0.377358490566038
"264","Bleckley",2010,13098,13034,64,0.491023477059997
"265","Bleckley",2011,13290,13098,192,1.46587265231333
"266","Bleckley",2012,12913,13290,-377,-2.83671933784801
"267","Bleckley",2013,12771,12913,-142,-1.0996670022458
"268","Bleckley",2014,12795,12771,24,0.187925769321118
"269","Bleckley",2015,12243,12795,-552,-4.31418522860492
"270","Bleckley",2016,12970,12243,727,5.93808707016254
"271","Bleckley",2017,12830,12970,-140,-1.07941403238242
"272","Bleckley",2018,12838,12830,8,0.0623538581449727
"273","Bleckley",2019,12873,12838,35,0.272628135223555
"274","Bleckley",2020,12955,12873,82,0.636992154121028
"275","Bleckley",2021,12607,12955,-348,-2.68622153608645
"276","Bleckley",2022,12257,12607,-350,-2.77623542476402
"277","Brantley",2000,14700,14369,331,2.30357018581669
"278","Brantley",2001,15093,14700,393,2.6734693877551
"279","Brantley",2002,15556,15093,463,3.06764725369377
"280","Brantley",2003,15911,15556,355,2.28207765492415
"281","Brantley",2004,16222,15911,311,1.95462258814657
"282","Brantley",2005,16535,16222,313,1.92947848600666
"283","Brantley",2006,16895,16535,360,2.17719987904445
"284","Brantley",2007,17198,16895,303,1.79343000887837
"285","Brantley",2008,17593,17198,395,2.29677869519712
"286","Brantley",2009,18129,17593,536,3.04666628772807
"287","Brantley",2010,18435,18129,306,1.68790335925865
"288","Brantley",2011,18367,18435,-68,-0.368863574721996
"289","Brantley",2012,18587,18367,220,1.1978004028965
"290","Brantley",2013,18292,18587,-295,-1.58713079033733
"291","Brantley",2014,18417,18292,125,0.683358845396895
"292","Brantley",2015,18455,18417,38,0.206331107129283
"293","Brantley",2016,18355,18455,-100,-0.541858574911948
"294","Brantley",2017,18731,18355,376,2.04848815036775
"295","Brantley",2018,18897,18731,166,0.886231381132881
"296","Brantley",2019,19109,18897,212,1.12187119648621
"297","Brantley",2020,19202,19109,93,0.486681668323826
"298","Brantley",2021,18101,19202,-1101,-5.7337777314863
"299","Brantley",2022,18183,18101,82,0.453013645654936
"300","Brooks",2000,16458,16379,79,0.482324928261799
"301","Brooks",2001,16307,16458,-151,-0.917486936444282
"302","Brooks",2002,16229,16307,-78,-0.478322192923284
"303","Brooks",2003,16051,16229,-178,-1.09680202107339
"304","Brooks",2004,16127,16051,76,0.473490748239985
"305","Brooks",2005,16124,16127,-3,-0.0186023438953308
"306","Brooks",2006,16309,16124,185,1.14735797568841
"307","Brooks",2007,16333,16309,24,0.147158010914219
"308","Brooks",2008,16475,16333,142,0.869405498071389
"309","Brooks",2009,16375,16475,-100,-0.606980273141123
"310","Brooks",2010,16199,16375,-176,-1.07480916030534
"311","Brooks",2011,15889,16199,-310,-1.91369837644299
"312","Brooks",2012,15403,15889,-486,-3.05871986909182
"313","Brooks",2013,15516,15403,113,0.733623320132442
"314","Brooks",2014,15418,15516,-98,-0.631606084042279
"315","Brooks",2015,15658,15418,240,1.55662212997795
"316","Brooks",2016,15687,15658,29,0.185208838932175
"317","Brooks",2017,15587,15687,-100,-0.637470516988589
"318","Brooks",2018,15513,15587,-74,-0.47475460319497
"319","Brooks",2019,15457,15513,-56,-0.360987558821633
"320","Brooks",2020,15357,15457,-100,-0.646956071682733
"321","Brooks",2021,16270,15357,913,5.94517158299147
"322","Brooks",2022,16253,16270,-17,-0.104486785494776
"323","Bryan",2000,23474,23150,324,1.39956803455724
"324","Bryan",2001,23867,23474,393,1.6741927238647
"325","Bryan",2002,24377,23867,510,2.13684166422257
"326","Bryan",2003,25069,24377,692,2.83874143660007
"327","Bryan",2004,26061,25069,992,3.9570784634409
"328","Bryan",2005,26557,26061,496,1.90322704424235
"329","Bryan",2006,27346,26557,789,2.97096810633731
"330","Bryan",2007,28302,27346,956,3.49594090543407
"331","Bryan",2008,29178,28302,876,3.09518761924952
"332","Bryan",2009,29987,29178,809,2.77263691822606
"333","Bryan",2010,30382,29987,395,1.31723746957015
"334","Bryan",2011,31377,30382,995,3.2749654400632
"335","Bryan",2012,32214,31377,837,2.66755904006119
"336","Bryan",2013,33157,32214,943,2.92729869001055
"337","Bryan",2014,33906,33157,749,2.25894984467835
"338","Bryan",2015,35137,33906,1231,3.63062584793252
"339","Bryan",2016,36230,35137,1093,3.11068104846743
"340","Bryan",2017,37060,36230,830,2.29091912779465
"341","Bryan",2018,38109,37060,1049,2.83054506206152
"342","Bryan",2019,39627,38109,1518,3.98331102889081
"343","Bryan",2020,40755,39627,1128,2.84654402301461
"344","Bryan",2021,46938,40755,6183,15.1711446448289
"345","Bryan",2022,48225,46938,1287,2.74191486641953
"346","Bulloch",2000,56146,55183,963,1.74510265842741
"347","Bulloch",2001,56808,56146,662,1.17906885619635
"348","Bulloch",2002,57361,56808,553,0.973454443036192
"349","Bulloch",2003,59314,57361,1953,3.40475235787382
"350","Bulloch",2004,60832,59314,1518,2.55926088275955
"351","Bulloch",2005,63048,60832,2216,3.64281956864808
"352","Bulloch",2006,64304,63048,1256,1.99213297804847
"353","Bulloch",2007,65768,64304,1464,2.27668574272207
"354","Bulloch",2008,67092,65768,1324,2.01313708794551
"355","Bulloch",2009,68598,67092,1506,2.24467894830978
"356","Bulloch",2010,70729,68598,2131,3.10650456281524
"357","Bulloch",2011,72881,70729,2152,3.04259921672864
"358","Bulloch",2012,72694,72881,-187,-0.256582648426888
"359","Bulloch",2013,71214,72694,-1480,-2.03593143863317
"360","Bulloch",2014,72087,71214,873,1.22588255118376
"361","Bulloch",2015,72651,72087,564,0.782387947896292
"362","Bulloch",2016,74722,72651,2071,2.85061458204292
"363","Bulloch",2017,76149,74722,1427,1.90974545649206
"364","Bulloch",2018,77296,76149,1147,1.50625746890964
"365","Bulloch",2019,79608,77296,2312,2.99109915131443
"366","Bulloch",2020,80839,79608,1231,1.54632700231133
"367","Bulloch",2021,82442,80839,1603,1.98295377231287
"368","Bulloch",2022,83059,82442,617,0.748404939230004
"369","Burke",2000,22279,22156,123,0.555154359992778
"370","Burke",2001,22582,22279,303,1.36002513577809
"371","Burke",2002,22626,22582,44,0.194845452130015
"372","Burke",2003,22692,22626,66,0.291699814372845
"373","Burke",2004,22867,22692,175,0.771196897585052
"374","Burke",2005,22939,22867,72,0.314864214807364
"375","Burke",2006,22875,22939,-64,-0.279000828283709
"376","Burke",2007,22972,22875,97,0.424043715846995
"377","Burke",2008,23084,22972,112,0.487550060943758
"378","Burke",2009,23117,23084,33,0.142956160110899
"379","Burke",2010,23367,23117,250,1.08145520612536
"380","Burke",2011,23504,23367,137,0.586296914452005
"381","Burke",2012,23125,23504,-379,-1.61249149081007
"382","Burke",2013,22923,23125,-202,-0.873513513513514
"383","Burke",2014,22709,22923,-214,-0.933560179732147
"384","Burke",2015,22745,22709,36,0.158527456074684
"385","Burke",2016,22688,22745,-57,-0.250604528467795
"386","Burke",2017,22522,22688,-166,-0.731664315937941
"387","Burke",2018,22423,22522,-99,-0.439570198028594
"388","Burke",2019,22383,22423,-40,-0.178388262052357
"389","Burke",2020,22648,22383,265,1.18393423580396
"390","Burke",2021,24310,22648,1662,7.33839632638644
"391","Burke",2022,24388,24310,78,0.320855614973262
"392","Butts",2000,19621,18927,694,3.66671950124161
"393","Butts",2001,20186,19621,565,2.87956780999949
"394","Butts",2002,20993,20186,807,3.99782027147528
"395","Butts",2003,21540,20993,547,2.60563044824465
"396","Butts",2004,21706,21540,166,0.770659238625812
"397","Butts",2005,22055,21706,349,1.60785036395467
"398","Butts",2006,22669,22055,614,2.78394921786443
"399","Butts",2007,23184,22669,515,2.27182495919538
"400","Butts",2008,23794,23184,610,2.63112491373361
"401","Butts",2009,23682,23794,-112,-0.470706900899386
"402","Butts",2010,23674,23682,-8,-0.0337809306646398
"403","Butts",2011,23504,23674,-170,-0.718087353214497
"404","Butts",2012,23524,23504,20,0.0850918992511913
"405","Butts",2013,23361,23524,-163,-0.692909369154906
"406","Butts",2014,23368,23361,7,0.0299644706990283
"407","Butts",2015,23593,23368,225,0.962855186579938
"408","Butts",2016,23817,23593,224,0.949434154198279
"409","Butts",2017,24059,23817,242,1.01608095058152
"410","Butts",2018,24193,24059,134,0.556964129847458
"411","Butts",2019,24936,24193,743,3.07113627908899
"412","Butts",2020,25426,24936,490,1.96503047802374
"413","Butts",2021,25781,25426,355,1.39620860536459
"414","Butts",2022,26649,25781,868,3.3668205267445
"415","Calhoun",2000,6325,6176,149,2.41256476683938
"416","Calhoun",2001,6271,6325,-54,-0.853754940711463
"417","Calhoun",2002,6359,6271,88,1.40328496252591
"418","Calhoun",2003,6286,6359,-73,-1.14797924201919
"419","Calhoun",2004,6306,6286,20,0.318167356029271
"420","Calhoun",2005,6256,6306,-50,-0.792895654931811
"421","Calhoun",2006,6350,6256,94,1.50255754475703
"422","Calhoun",2007,6269,6350,-81,-1.2755905511811
"423","Calhoun",2008,6456,6269,187,2.98293188706333
"424","Calhoun",2009,6670,6456,214,3.31474597273854
"425","Calhoun",2010,6697,6670,27,0.4047976011994
"426","Calhoun",2011,6740,6697,43,0.642078542631029
"427","Calhoun",2012,6504,6740,-236,-3.50148367952522
"428","Calhoun",2013,6523,6504,19,0.292127921279213
"429","Calhoun",2014,6463,6523,-60,-0.919822167714242
"430","Calhoun",2015,6479,6463,16,0.247563051214606
"431","Calhoun",2016,6324,6479,-155,-2.39234449760766
"432","Calhoun",2017,6455,6324,131,2.07147375079064
"433","Calhoun",2018,6352,6455,-103,-1.59566227730442
"434","Calhoun",2019,6189,6352,-163,-2.56612090680101
"435","Calhoun",2020,6231,6189,42,0.678623364032962
"436","Calhoun",2021,5509,6231,-722,-11.5872251645001
"437","Calhoun",2022,5469,5509,-40,-0.726084588854602
"438","Camden",2000,43824,43574,250,0.573736631936476
"439","Camden",2001,44469,43824,645,1.47179627601314
"440","Camden",2002,45299,44469,830,1.86646877600126
"441","Camden",2003,44568,45299,-731,-1.61372215722201
"442","Camden",2004,46096,44568,1528,3.42846885657871
"443","Camden",2005,46673,46096,577,1.25173550850399
"444","Camden",2006,47086,46673,413,0.884879909155186
"445","Camden",2007,48947,47086,1861,3.95234252219343
"446","Camden",2008,49713,48947,766,1.56495801581302
"447","Camden",2009,50024,49713,311,0.625590891718464
"448","Camden",2010,50697,50024,673,1.34535422996961
"449","Camden",2011,50410,50697,-287,-0.566108448231651
"450","Camden",2012,51402,50410,992,1.96786351914303
"451","Camden",2013,51476,51402,74,0.143963269911677
"452","Camden",2014,52027,51476,551,1.07040174061699
"453","Camden",2015,52102,52027,75,0.144155919042036
"454","Camden",2016,53008,52102,906,1.73889677939426
"455","Camden",2017,53044,53008,36,0.0679142770902505
"456","Camden",2018,53677,53044,633,1.1933489178795
"457","Camden",2019,54666,53677,989,1.84250237531904
"458","Camden",2020,55388,54666,722,1.32074781399773
"459","Camden",2021,55664,55388,276,0.498302881490576
"460","Camden",2022,57013,55664,1349,2.4234693877551
"461","Candler",2000,9585,9530,55,0.577124868835257
"462","Candler",2001,9442,9585,-143,-1.49191444966093
"463","Candler",2002,9772,9442,330,3.49502224105062
"464","Candler",2003,9937,9772,165,1.68849774866967
"465","Candler",2004,10039,9937,102,1.02646674046493
"466","Candler",2005,10158,10039,119,1.18537702958462
"467","Candler",2006,10388,10158,230,2.26422524118921
"468","Candler",2007,10586,10388,198,1.90604543704274
"469","Candler",2008,10691,10586,105,0.991876062724353
"470","Candler",2009,10880,10691,189,1.76784211018614
"471","Candler",2010,11030,10880,150,1.37867647058824
"472","Candler",2011,11276,11030,246,2.23028105167724
"473","Candler",2012,11117,11276,-159,-1.4100744945016
"474","Candler",2013,10937,11117,-180,-1.61914185481695
"475","Candler",2014,10888,10937,-49,-0.448020480936271
"476","Candler",2015,10886,10888,-2,-0.0183688464364438
"477","Candler",2016,10910,10886,24,0.220466654418519
"478","Candler",2017,10797,10910,-113,-1.03574702108158
"479","Candler",2018,10836,10797,39,0.36121144762434
"480","Candler",2019,10803,10836,-33,-0.304540420819491
"481","Candler",2020,10985,10803,182,1.68471720818291
"482","Candler",2021,11037,10985,52,0.473372781065089
"483","Candler",2022,11000,11037,-37,-0.335236024281961
"484","Carroll",2000,87932,85082,2850,3.34970969182671
"485","Carroll",2001,91132,87932,3200,3.6391757266979
"486","Carroll",2002,94087,91132,2955,3.24254926919194
"487","Carroll",2003,97396,94087,3309,3.51695770935411
"488","Carroll",2004,99774,97396,2378,2.44157870959793
"489","Carroll",2005,102526,99774,2752,2.75823360795398
"490","Carroll",2006,105853,102526,3327,3.24503052884146
"491","Carroll",2007,108947,105853,3094,2.92292140987974
"492","Carroll",2008,110242,108947,1295,1.18865136258915
"493","Carroll",2009,110433,110242,191,0.173255202191542
"494","Carroll",2010,110661,110433,228,0.206460025535845
"495","Carroll",2011,111159,110661,498,0.450023043348605
"496","Carroll",2012,111580,111159,421,0.37873676445452
"497","Carroll",2013,112355,111580,775,0.69456891916114
"498","Carroll",2014,114093,112355,1738,1.54688264874727
"499","Carroll",2015,114545,114093,452,0.396168038354676
"500","Carroll",2016,116261,114545,1716,1.4981011829412
"501","Carroll",2017,117812,116261,1551,1.3340673140606
"502","Carroll",2018,118121,117812,309,0.262282280243099
"503","Carroll",2019,119992,118121,1871,1.5839689809602
"504","Carroll",2020,121633,119992,1641,1.36759117274485
"505","Carroll",2021,121968,121633,335,0.275418677497061
"506","Carroll",2022,124592,121968,2624,2.15138396956579
"507","Catoosa",2000,53549,52118,1431,2.7456924670939
"508","Catoosa",2001,54638,53549,1089,2.03365142206204
"509","Catoosa",2002,56024,54638,1386,2.53669607233061
"510","Catoosa",2003,57614,56024,1590,2.83806939882907
"511","Catoosa",2004,58866,57614,1252,2.17308293123199
"512","Catoosa",2005,59745,58866,879,1.49322189379268
"513","Catoosa",2006,61095,59745,1350,2.25960331408486
"514","Catoosa",2007,62539,61095,1444,2.36353220394468
"515","Catoosa",2008,63271,62539,732,1.17046962695278
"516","Catoosa",2009,63874,63271,603,0.953043258364812
"517","Catoosa",2010,63975,63874,101,0.158123806243542
"518","Catoosa",2011,64530,63975,555,0.867526377491207
"519","Catoosa",2012,65046,64530,516,0.799628079962808
"520","Catoosa",2013,65311,65046,265,0.407403991021738
"521","Catoosa",2014,65621,65311,310,0.474652049425059
"522","Catoosa",2015,66050,65621,429,0.653754133585285
"523","Catoosa",2016,66398,66050,348,0.526873580620742
"524","Catoosa",2017,66550,66398,152,0.228922557908371
"525","Catoosa",2018,67420,66550,870,1.30728775356875
"526","Catoosa",2019,67580,67420,160,0.237318303174132
"527","Catoosa",2020,67996,67580,416,0.615566735720627
"528","Catoosa",2021,68397,67996,401,0.589740572974881
"529","Catoosa",2022,68826,68397,429,0.627220492126848
"530","Charlton",2000,10312,10258,54,0.526418405147202
"531","Charlton",2001,10675,10312,363,3.52017067494182
"532","Charlton",2002,10910,10675,235,2.20140515222482
"533","Charlton",2003,11282,10910,372,3.40971585701192
"534","Charlton",2004,11378,11282,96,0.850912958695267
"535","Charlton",2005,11635,11378,257,2.25874494638777
"536","Charlton",2006,12089,11635,454,3.90201976794156
"537","Charlton",2007,12056,12089,-33,-0.272975432211101
"538","Charlton",2008,12604,12056,548,4.54545454545455
"539","Charlton",2009,12665,12604,61,0.483973341796255
"540","Charlton",2010,12137,12665,-528,-4.16896960126332
"541","Charlton",2011,13422,12137,1285,10.5874598335668
"542","Charlton",2012,13295,13422,-127,-0.946207718670839
"543","Charlton",2013,13255,13295,-40,-0.300864986837157
"544","Charlton",2014,12897,13255,-358,-2.70086759713316
"545","Charlton",2015,12965,12897,68,0.52725440024812
"546","Charlton",2016,12497,12965,-468,-3.60971847281142
"547","Charlton",2017,12715,12497,218,1.74441866047852
"548","Charlton",2018,12968,12715,253,1.98977585528903
"549","Charlton",2019,13392,12968,424,3.26958667489204
"550","Charlton",2020,13430,13392,38,0.283751493428913
"551","Charlton",2021,12766,13430,-664,-4.94415487714073
"552","Charlton",2022,12781,12766,15,0.117499608334639
"553","Chatham",2000,232492,231630,862,0.372145231619393
"554","Chatham",2001,234150,232492,1658,0.713142817817387
"555","Chatham",2002,236510,234150,2360,1.00790091821482
"556","Chatham",2003,237348,236510,838,0.35431905627669
"557","Chatham",2004,240818,237348,3470,1.46198830409357
"558","Chatham",2005,242241,240818,1423,0.590902673388202
"559","Chatham",2006,246896,242241,4655,1.92164001964985
"560","Chatham",2007,251981,246896,5085,2.05957164150088
"561","Chatham",2008,255269,251981,3288,1.30486028708514
"562","Chatham",2009,262122,255269,6853,2.68461897057614
"563","Chatham",2010,265871,262122,3749,1.43025003624267
"564","Chatham",2011,271544,265871,5673,2.13374155135385
"565","Chatham",2012,276434,271544,4890,1.80081312789088
"566","Chatham",2013,278434,276434,2000,0.7235000036175
"567","Chatham",2014,283379,278434,4945,1.77600436728273
"568","Chatham",2015,286956,283379,3577,1.26226714047265
"569","Chatham",2016,289082,286956,2126,0.740880134933579
"570","Chatham",2017,290501,289082,1419,0.490864183864786
"571","Chatham",2018,289195,290501,-1306,-0.449568159834217
"572","Chatham",2019,289430,289195,235,0.0812600494476046
"573","Chatham",2020,289463,289430,33,0.0114017206232941
"574","Chatham",2021,296329,289463,6866,2.3719784566594
"575","Chatham",2022,301107,296329,4778,1.61239703167763
"576","Chattahoochee",2000,15047,14781,266,1.79960760435694
"577","Chattahoochee",2001,15780,15047,733,4.87140293746262
"578","Chattahoochee",2002,18043,15780,2263,14.340937896071
"579","Chattahoochee",2003,15289,18043,-2754,-15.2635371058028
"580","Chattahoochee",2004,15515,15289,226,1.47818693178102
"581","Chattahoochee",2005,14096,15515,-1419,-9.14598775378666
"582","Chattahoochee",2006,11828,14096,-2268,-16.0896708286039
"583","Chattahoochee",2007,11965,11828,137,1.15826851538722
"584","Chattahoochee",2008,11624,11965,-341,-2.84997910572503
"585","Chattahoochee",2009,11955,11624,331,2.84755677907777
"586","Chattahoochee",2010,11136,11955,-819,-6.85069008782936
"587","Chattahoochee",2011,11749,11136,613,5.50466954022989
"588","Chattahoochee",2012,13037,11749,1288,10.9626351178824
"589","Chattahoochee",2013,12842,13037,-195,-1.4957428856332
"590","Chattahoochee",2014,11837,12842,-1005,-7.82588381871983
"591","Chattahoochee",2015,11368,11837,-469,-3.96215257244234
"592","Chattahoochee",2016,10922,11368,-446,-3.92329345531316
"593","Chattahoochee",2017,10343,10922,-579,-5.30122688152353
"594","Chattahoochee",2018,10684,10343,341,3.29691578845596
"595","Chattahoochee",2019,10907,10684,223,2.08723324597529
"596","Chattahoochee",2020,10551,10907,-356,-3.26395892546071
"597","Chattahoochee",2021,9048,10551,-1503,-14.2450952516349
"598","Chattahoochee",2022,8819,9048,-229,-2.53094606542882
"599","Chattooga",2000,25419,25158,261,1.03744335797758
"600","Chattooga",2001,25675,25419,256,1.00712065777568
"601","Chattooga",2002,25688,25675,13,0.0506329113924051
"602","Chattooga",2003,25981,25688,293,1.140610401744
"603","Chattooga",2004,25537,25981,-444,-1.70894114930141
"604","Chattooga",2005,25506,25537,-31,-0.121392489329209
"605","Chattooga",2006,25640,25506,134,0.525366580412452
"606","Chattooga",2007,26230,25640,590,2.30109204368175
"607","Chattooga",2008,26146,26230,-84,-0.320243995425086
"608","Chattooga",2009,25894,26146,-252,-0.963818557331905
"609","Chattooga",2010,26016,25894,122,0.471151618135475
"610","Chattooga",2011,25736,26016,-280,-1.07626076260763
"611","Chattooga",2012,25725,25736,-11,-0.0427416847995026
"612","Chattooga",2013,25138,25725,-587,-2.28182701652089
"613","Chattooga",2014,24939,25138,-199,-0.791630201288885
"614","Chattooga",2015,24922,24939,-17,-0.0681663258350375
"615","Chattooga",2016,24824,24922,-98,-0.393226867827622
"616","Chattooga",2017,24770,24824,-54,-0.217531421205285
"617","Chattooga",2018,24790,24770,20,0.080742834073476
"618","Chattooga",2019,24789,24790,-1,-0.00403388463089956
"619","Chattooga",2020,24843,24789,54,0.217838557424664
"620","Chattooga",2021,24932,24843,89,0.358249808799259
"621","Chattooga",2022,24936,24932,4,0.0160436386972565
"622","Cherokee",2000,143777,137416,6361,4.62900972230308
"623","Cherokee",2001,151189,143777,7412,5.15520563094236
"624","Cherokee",2002,158682,151189,7493,4.95604838976381
"625","Cherokee",2003,165585,158682,6903,4.3502098536696
"626","Cherokee",2004,173105,165585,7520,4.54147416734608
"627","Cherokee",2005,182128,173105,9023,5.21244331475116
"628","Cherokee",2006,193241,182128,11113,6.10175261354652
"629","Cherokee",2007,202544,193241,9303,4.81419574520935
"630","Cherokee",2008,208271,202544,5727,2.82753377044
"631","Cherokee",2009,212232,208271,3961,1.90184903323074
"632","Cherokee",2010,215129,212232,2897,1.36501564325832
"633","Cherokee",2011,218286,215129,3157,1.46749159806442
"634","Cherokee",2012,221315,218286,3029,1.38762907378393
"635","Cherokee",2013,225106,221315,3791,1.7129430901656
"636","Cherokee",2014,230985,225106,5879,2.61165850754756
"637","Cherokee",2015,235900,230985,4915,2.12784379938091
"638","Cherokee",2016,241689,235900,5789,2.4540059347181
"639","Cherokee",2017,247573,241689,5884,2.4345336362019
"640","Cherokee",2018,254149,247573,6576,2.65618625617495
"641","Cherokee",2019,258773,254149,4624,1.81940515209582
"642","Cherokee",2020,265274,258773,6501,2.51224045785302
"643","Cherokee",2021,274615,265274,9341,3.52126480544644
"644","Cherokee",2022,281278,274615,6663,2.42630591919597
"645","Clarke",2000,102401,100173,2228,2.22415221666517
"646","Clarke",2001,103890,102401,1489,1.4540873624281
"647","Clarke",2002,104673,103890,783,0.753681778804505
"648","Clarke",2003,106287,104673,1614,1.54194491416125
"649","Clarke",2004,109752,106287,3465,3.26004120917892
"650","Clarke",2005,109536,109752,-216,-0.196807347474306
"651","Clarke",2006,112074,109536,2538,2.31704645048203
"652","Clarke",2007,113995,112074,1921,1.71404607669932
"653","Clarke",2008,115768,113995,1773,1.55533137418308
"654","Clarke",2009,116843,115768,1075,0.928581300532099
"655","Clarke",2010,116668,116843,-175,-0.149773627859606
"656","Clarke",2011,117344,116668,676,0.579421949463435
"657","Clarke",2012,120266,117344,2922,2.49011453504227
"658","Clarke",2013,121265,120266,999,0.83065870653385
"659","Clarke",2014,120938,121265,-327,-0.269657361975838
"660","Clarke",2015,123912,120938,2974,2.45911128016008
"661","Clarke",2016,124707,123912,795,0.641584350184002
"662","Clarke",2017,127064,124707,2357,1.89003023086114
"663","Clarke",2018,127330,127064,266,0.209343323049802
"664","Clarke",2019,128331,127330,1001,0.786146234194612
"665","Clarke",2020,127795,128331,-536,-0.417669931661095
"666","Clarke",2021,128711,127795,916,0.716772956688446
"667","Clarke",2022,129875,128711,1164,0.904351609419552
"668","Clay",2000,3353,3347,6,0.179265013444876
"669","Clay",2001,3360,3353,7,0.208768267223382
"670","Clay",2002,3314,3360,-46,-1.36904761904762
"671","Clay",2003,3303,3314,-11,-0.331925165962583
"672","Clay",2004,3233,3303,-70,-2.11928549803209
"673","Clay",2005,3216,3233,-17,-0.525827404887102
"674","Clay",2006,3232,3216,16,0.497512437810945
"675","Clay",2007,3262,3232,30,0.928217821782178
"676","Clay",2008,3233,3262,-29,-0.889025137952177
"677","Clay",2009,3201,3233,-32,-0.989792762140427
"678","Clay",2010,3175,3201,-26,-0.812246173070915
"679","Clay",2011,3111,3175,-64,-2.01574803149606
"680","Clay",2012,3116,3111,5,0.160720025715204
"681","Clay",2013,3045,3116,-71,-2.2785622593068
"682","Clay",2014,3102,3045,57,1.87192118226601
"683","Clay",2015,3141,3102,39,1.25725338491296
"684","Clay",2016,3020,3141,-121,-3.85227634511302
"685","Clay",2017,2962,3020,-58,-1.9205298013245
"686","Clay",2018,2887,2962,-75,-2.5320729237002
"687","Clay",2019,2834,2887,-53,-1.83581572566678
"688","Clay",2020,2866,2834,32,1.12914608327452
"689","Clay",2021,2882,2866,16,0.558269364968597
"690","Clay",2022,2845,2882,-37,-1.28383067314365
"691","Clayton",2000,238079,229966,8113,3.52791282189541
"692","Clayton",2001,245327,238079,7248,3.04436762587208
"693","Clayton",2002,248954,245327,3627,1.47843490524891
"694","Clayton",2003,252631,248954,3677,1.47697968299365
"695","Clayton",2004,255322,252631,2691,1.06518994106028
"696","Clayton",2005,256292,255322,970,0.379912424311262
"697","Clayton",2006,258552,256292,2260,0.88180668924508
"698","Clayton",2007,260441,258552,1889,0.730607382654166
"699","Clayton",2008,262099,260441,1658,0.636612514926605
"700","Clayton",2009,260067,262099,-2032,-0.775279569933498
"701","Clayton",2010,259623,260067,-444,-0.170725236189136
"702","Clayton",2011,261532,259623,1909,0.735296949807991
"703","Clayton",2012,265888,261532,4356,1.66557056115504
"704","Clayton",2013,264220,265888,-1668,-0.627331808881935
"705","Clayton",2014,267542,264220,3322,1.25728559533722
"706","Clayton",2015,273955,267542,6413,2.39700682509662
"707","Clayton",2016,279462,273955,5507,2.01018415433192
"708","Clayton",2017,285153,279462,5691,2.03641282177899
"709","Clayton",2018,289615,285153,4462,1.56477399852009
"710","Clayton",2019,292256,289615,2641,0.911900281408076
"711","Clayton",2020,292646,292256,390,0.133444651264645
"712","Clayton",2021,297100,292646,4454,1.52197535589073
"713","Clayton",2022,296564,297100,-536,-0.180410636149445
"714","Clinch",2000,6831,6892,-61,-0.885084155542658
"715","Clinch",2001,6901,6831,70,1.02474015517494
"716","Clinch",2002,6870,6901,-31,-0.449210259382698
"717","Clinch",2003,6933,6870,63,0.917030567685589
"718","Clinch",2004,6893,6933,-40,-0.576950814943026
"719","Clinch",2005,6948,6893,55,0.797910924125925
"720","Clinch",2006,6828,6948,-120,-1.72711571675302
"721","Clinch",2007,6838,6828,10,0.146455770357352
"722","Clinch",2008,6941,6838,103,1.50628838841767
"723","Clinch",2009,6799,6941,-142,-2.04581472410316
"724","Clinch",2010,6800,6799,1,0.0147080453007795
"725","Clinch",2011,6777,6800,-23,-0.338235294117647
"726","Clinch",2012,6718,6777,-59,-0.870591707245094
"727","Clinch",2013,6795,6718,77,1.14617445668354
"728","Clinch",2014,6831,6795,36,0.529801324503311
"729","Clinch",2015,6893,6831,62,0.907626994583516
"730","Clinch",2016,6829,6893,-64,-0.928478166255622
"731","Clinch",2017,6727,6829,-102,-1.49363010689706
"732","Clinch",2018,6648,6727,-79,-1.17437193399732
"733","Clinch",2019,6618,6648,-30,-0.451263537906137
"734","Clinch",2020,6582,6618,-36,-0.543970988213962
"735","Clinch",2021,6725,6582,143,2.17259191735035
"736","Clinch",2022,6662,6725,-63,-0.936802973977695
"737","Cobb",2000,611505,588871,22634,3.84362619317304
"738","Cobb",2001,623006,611505,11501,1.88076957670011
"739","Cobb",2002,631018,623006,8012,1.28602292754805
"740","Cobb",2003,634638,631018,3620,0.573676186733184
"741","Cobb",2004,640346,634638,5708,0.89941037252733
"742","Cobb",2005,646754,640346,6408,1.00070899170136
"743","Cobb",2006,661913,646754,15159,2.34385871598784
"744","Cobb",2007,670438,661913,8525,1.28793361061046
"745","Cobb",2008,679822,670438,9384,1.39968199893204
"746","Cobb",2009,684776,679822,4954,0.728720164984364
"747","Cobb",2010,690063,684776,5287,0.772077292428473
"748","Cobb",2011,697553,690063,7490,1.08540814389411
"749","Cobb",2012,707442,697553,9889,1.4176700551786
"750","Cobb",2013,717190,707442,9748,1.37792214768136
"751","Cobb",2014,730981,717190,13791,1.92292140158117
"752","Cobb",2015,741334,730981,10353,1.41631588235536
"753","Cobb",2016,748150,741334,6816,0.91942363361184
"754","Cobb",2017,755754,748150,7604,1.01637372184722
"755","Cobb",2018,756865,755754,1111,0.147005507082993
"756","Cobb",2019,760141,756865,3276,0.432838088694813
"757","Cobb",2020,762944,760141,2803,0.368747377131348
"758","Cobb",2021,766802,762944,3858,0.505672762352152
"759","Cobb",2022,771952,766802,5150,0.671620574802883
"760","Coffee",2000,37592,36813,779,2.11610029065819
"761","Coffee",2001,38350,37592,758,2.01638646520536
"762","Coffee",2002,38791,38350,441,1.14993481095176
"763","Coffee",2003,39183,38791,392,1.01054368281302
"764","Coffee",2004,39383,39183,200,0.51042543960391
"765","Coffee",2005,39829,39383,446,1.1324683238961
"766","Coffee",2006,40702,39829,873,2.19187024529865
"767","Coffee",2007,41299,40702,597,1.46675839025109
"768","Coffee",2008,41813,41299,514,1.24458219327344
"769","Coffee",2009,42089,41813,276,0.660081792743883
"770","Coffee",2010,42332,42089,243,0.577348000665257
"771","Coffee",2011,42864,42332,532,1.25673249551167
"772","Coffee",2012,43170,42864,306,0.713885778275476
"773","Coffee",2013,43220,43170,50,0.115821172110262
"774","Coffee",2014,42811,43220,-409,-0.946321147616844
"775","Coffee",2015,43108,42811,297,0.693746934199154
"776","Coffee",2016,43012,43108,-96,-0.222696483251369
"777","Coffee",2017,43014,43012,2,0.00464986515391054
"778","Coffee",2018,43093,43014,79,0.183661133584414
"779","Coffee",2019,43273,43093,180,0.41770125078319
"780","Coffee",2020,43218,43273,-55,-0.127100039285467
"781","Coffee",2021,43386,43218,168,0.388726919339164
"782","Coffee",2022,43172,43386,-214,-0.493246669432536
"783","Colquitt",2000,42140,41737,403,0.965570117641421
"784","Colquitt",2001,42223,42140,83,0.196962505932606
"785","Colquitt",2002,42570,42223,347,0.821826966345357
"786","Colquitt",2003,42554,42570,-16,-0.0375851538642236
"787","Colquitt",2004,42987,42554,433,1.01753066691733
"788","Colquitt",2005,42993,42987,6,0.0139577081443227
"789","Colquitt",2006,43700,42993,707,1.6444537482846
"790","Colquitt",2007,44209,43700,509,1.16475972540046
"791","Colquitt",2008,44872,44209,663,1.49969463231469
"792","Colquitt",2009,45152,44872,280,0.623997147441612
"793","Colquitt",2010,45628,45152,476,1.05421686746988
"794","Colquitt",2011,45645,45628,17,0.03725782414307
"795","Colquitt",2012,46137,45645,492,1.07788366743345
"796","Colquitt",2013,46275,46137,138,0.29910917484882
"797","Colquitt",2014,46102,46275,-173,-0.373851971907077
"798","Colquitt",2015,45844,46102,-258,-0.55962864951629
"799","Colquitt",2016,45708,45844,-136,-0.296658232265945
"800","Colquitt",2017,45835,45708,127,0.277850704471865
"801","Colquitt",2018,45592,45835,-243,-0.530162539544017
"802","Colquitt",2019,45600,45592,8,0.0175469380593087
"803","Colquitt",2020,45542,45600,-58,-0.12719298245614
"804","Colquitt",2021,45812,45542,270,0.592859338632471
"805","Colquitt",2022,45762,45812,-50,-0.109141709595739
"806","Columbia",2000,90138,88280,1858,2.10466696873584
"807","Columbia",2001,92537,90138,2399,2.66147462779294
"808","Columbia",2002,95818,92537,3281,3.54560878351362
"809","Columbia",2003,98761,95818,2943,3.07144795341168
"810","Columbia",2004,102934,98761,4173,4.22535211267606
"811","Columbia",2005,106477,102934,3543,3.44201138593662
"812","Columbia",2006,110845,106477,4368,4.10229439221616
"813","Columbia",2007,115074,110845,4229,3.81523749379765
"814","Columbia",2008,117504,115074,2430,2.11168465509151
"815","Columbia",2009,121050,117504,3546,3.01776960784314
"816","Columbia",2010,124815,121050,3765,3.11028500619579
"817","Columbia",2011,128112,124815,3297,2.64150943396226
"818","Columbia",2012,131627,128112,3515,2.74369301860872
"819","Columbia",2013,135416,131627,3789,2.87858873939237
"820","Columbia",2014,139257,135416,3841,2.83644473326638
"821","Columbia",2015,144052,139257,4795,3.44327394673158
"822","Columbia",2016,147450,144052,3398,2.35887040790826
"823","Columbia",2017,151579,147450,4129,2.80027127839946
"824","Columbia",2018,154291,151579,2712,1.78916604542846
"825","Columbia",2019,156714,154291,2423,1.57040916190834
"826","Columbia",2020,160377,156714,3663,2.33737891956047
"827","Columbia",2021,159639,160377,-738,-0.460165734488112
"828","Columbia",2022,162419,159639,2780,1.74142909940553
"829","Cook",2000,15855,15563,292,1.87624493992161
"830","Cook",2001,15885,15855,30,0.189214758751183
"831","Cook",2002,15985,15885,100,0.629524708844822
"832","Cook",2003,16060,15985,75,0.469189865498905
"833","Cook",2004,16268,16060,208,1.29514321295143
"834","Cook",2005,16567,16268,299,1.83796410130317
"835","Cook",2006,16622,16567,55,0.331985271926118
"836","Cook",2007,16848,16622,226,1.35964384550596
"837","Cook",2008,17067,16848,219,1.29985754985755
"838","Cook",2009,17114,17067,47,0.275385246381907
"839","Cook",2010,17227,17114,113,0.660278134860348
"840","Cook",2011,17125,17227,-102,-0.5920938062344
"841","Cook",2012,16923,17125,-202,-1.17956204379562
"842","Cook",2013,17066,16923,143,0.84500384092655
"843","Cook",2014,17214,17066,148,0.867221375834993
"844","Cook",2015,17124,17214,-90,-0.522830254444057
"845","Cook",2016,17167,17124,43,0.25110955384256
"846","Cook",2017,17277,17167,110,0.640764257004718
"847","Cook",2018,17162,17277,-115,-0.66562481912369
"848","Cook",2019,17270,17162,108,0.629297284698753
"849","Cook",2020,17291,17270,21,0.121598147075854
"850","Cook",2021,17225,17291,-66,-0.381701463188942
"851","Cook",2022,17404,17225,179,1.03918722786647
"852","Counties are listed in alphabetical/FIPS order. If copying/pasting into another spreadsheet of data by county name, beware that DeKalb, McIntosh, McDuffie may be in a different order.",2000,NA,NA,NA,NA
"853","Counties are listed in alphabetical/FIPS order. If copying/pasting into another spreadsheet of data by county name, beware that DeKalb, McIntosh, McDuffie may be in a different order.",2001,NA,NA,NA,NA
"854","Counties are listed in alphabetical/FIPS order. If copying/pasting into another spreadsheet of data by county name, beware that DeKalb, McIntosh, McDuffie may be in a different order.",2002,NA,NA,NA,NA
"855","Counties are listed in alphabetical/FIPS order. If copying/pasting into another spreadsheet of data by county name, beware that DeKalb, McIntosh, McDuffie may be in a different order.",2003,NA,NA,NA,NA
"856","Counties are listed in alphabetical/FIPS order. If copying/pasting into another spreadsheet of data by county name, beware that DeKalb, McIntosh, McDuffie may be in a different order.",2004,NA,NA,NA,NA
"857","Counties are listed in alphabetical/FIPS order. If copying/pasting into another spreadsheet of data by county name, beware that DeKalb, McIntosh, McDuffie may be in a different order.",2005,NA,NA,NA,NA
"858","Counties are listed in alphabetical/FIPS order. If copying/pasting into another spreadsheet of data by county name, beware that DeKalb, McIntosh, McDuffie may be in a different order.",2006,NA,NA,NA,NA
"859","Counties are listed in alphabetical/FIPS order. If copying/pasting into another spreadsheet of data by county name, beware that DeKalb, McIntosh, McDuffie may be in a different order.",2007,NA,NA,NA,NA
"860","Counties are listed in alphabetical/FIPS order. If copying/pasting into another spreadsheet of data by county name, beware that DeKalb, McIntosh, McDuffie may be in a different order.",2008,NA,NA,NA,NA
"861","Counties are listed in alphabetical/FIPS order. If copying/pasting into another spreadsheet of data by county name, beware that DeKalb, McIntosh, McDuffie may be in a different order.",2009,NA,NA,NA,NA
"862","Counties are listed in alphabetical/FIPS order. If copying/pasting into another spreadsheet of data by county name, beware that DeKalb, McIntosh, McDuffie may be in a different order.",2010,NA,NA,NA,NA
"863","Counties are listed in alphabetical/FIPS order. If copying/pasting into another spreadsheet of data by county name, beware that DeKalb, McIntosh, McDuffie may be in a different order.",2011,NA,NA,NA,NA
"864","Counties are listed in alphabetical/FIPS order. If copying/pasting into another spreadsheet of data by county name, beware that DeKalb, McIntosh, McDuffie may be in a different order.",2012,NA,NA,NA,NA
"865","Counties are listed in alphabetical/FIPS order. If copying/pasting into another spreadsheet of data by county name, beware that DeKalb, McIntosh, McDuffie may be in a different order.",2013,NA,NA,NA,NA
"866","Counties are listed in alphabetical/FIPS order. If copying/pasting into another spreadsheet of data by county name, beware that DeKalb, McIntosh, McDuffie may be in a different order.",2014,NA,NA,NA,NA
"867","Counties are listed in alphabetical/FIPS order. If copying/pasting into another spreadsheet of data by county name, beware that DeKalb, McIntosh, McDuffie may be in a different order.",2015,NA,NA,NA,NA
"868","Counties are listed in alphabetical/FIPS order. If copying/pasting into another spreadsheet of data by county name, beware that DeKalb, McIntosh, McDuffie may be in a different order.",2016,NA,NA,NA,NA
"869","Counties are listed in alphabetical/FIPS order. If copying/pasting into another spreadsheet of data by county name, beware that DeKalb, McIntosh, McDuffie may be in a different order.",2017,NA,NA,NA,NA
"870","Counties are listed in alphabetical/FIPS order. If copying/pasting into another spreadsheet of data by county name, beware that DeKalb, McIntosh, McDuffie may be in a different order.",2018,NA,NA,NA,NA
"871","Counties are listed in alphabetical/FIPS order. If copying/pasting into another spreadsheet of data by county name, beware that DeKalb, McIntosh, McDuffie may be in a different order.",2019,NA,NA,NA,NA
"872","Counties are listed in alphabetical/FIPS order. If copying/pasting into another spreadsheet of data by county name, beware that DeKalb, McIntosh, McDuffie may be in a different order.",2020,NA,NA,NA,NA
"873","Counties are listed in alphabetical/FIPS order. If copying/pasting into another spreadsheet of data by county name, beware that DeKalb, McIntosh, McDuffie may be in a different order.",2021,NA,NA,NA,NA
"874","Counties are listed in alphabetical/FIPS order. If copying/pasting into another spreadsheet of data by county name, beware that DeKalb, McIntosh, McDuffie may be in a different order.",2022,NA,NA,NA,NA
"875","County Summary",2000,8227303,8045965,181338,2.25377565027936
"876","County Summary",2001,8377038,8227303,149735,1.81997672870441
"877","County Summary",2002,8508256,8377038,131218,1.56640091640983
"878","County Summary",2003,8622793,8508256,114537,1.34618657454595
"879","County Summary",2004,8769252,8622793,146459,1.69850998394604
"880","County Summary",2005,8925921,8769252,156669,1.78657199040465
"881","County Summary",2006,9155813,8925921,229892,2.5755549483353
"882","County Summary",2007,9349988,9155813,194175,2.12078381242605
"883","County Summary",2008,9504843,9349988,154855,1.65620533416727
"884","County Summary",2009,9620846,9504843,116003,1.22046203182946
"885","County Summary",2010,9712587,9620846,91741,0.953564790456058
"886","County Summary",2011,9815210,9712587,102623,1.05659800010028
"887","County Summary",2012,9919945,9815210,104735,1.06706835615336
"888","County Summary",2013,9992167,9919945,72222,0.728048391397331
"889","County Summary",2014,10097343,9992167,105176,1.05258448943057
"890","County Summary",2015,10214860,10097343,117517,1.16384082426436
"891","County Summary",2016,10310371,10214860,95511,0.93502015690866
"892","County Summary",2017,10429379,10310371,119008,1.15425526394734
"893","County Summary",2018,10519475,10429379,90096,0.863867350107806
"894","County Summary",2019,10617423,10519475,97948,0.931111105829901
"895","County Summary",2020,10710017,10617423,92594,0.872094857669323
"896","County Summary",2021,10799566,10710017,89549,0.836123789532734
"897","County Summary",2022,10912876,10799566,113310,1.04920882931777
"898","Coweta",2000,90117,86837,3280,3.77719175006046
"899","Coweta",2001,93627,90117,3510,3.89493658244282
"900","Coweta",2002,97191,93627,3564,3.80659425165818
"901","Coweta",2003,100382,97191,3191,3.28322581308969
"902","Coweta",2004,104089,100382,3707,3.69289314817398
"903","Coweta",2005,108371,104089,4282,4.11378723976597
"904","Coweta",2006,113749,108371,5378,4.96258224063633
"905","Coweta",2007,118156,113749,4407,3.87431977423977
"906","Coweta",2008,122281,118156,4125,3.49114729679407
"907","Coweta",2009,125501,122281,3220,2.63327908669376
"908","Coweta",2010,127955,125501,2454,1.95536290547486
"909","Coweta",2011,129629,127955,1674,1.30827243952952
"910","Coweta",2012,130929,129629,1300,1.00286201390121
"911","Coweta",2013,133180,130929,2251,1.71925241925013
"912","Coweta",2014,135571,133180,2391,1.79531461180357
"913","Coweta",2015,138427,135571,2856,2.10664522648649
"914","Coweta",2016,140526,138427,2099,1.51632268271363
"915","Coweta",2017,143114,140526,2588,1.8416520786189
"916","Coweta",2018,145864,143114,2750,1.92154506197856
"917","Coweta",2019,148509,145864,2645,1.81333296769594
"918","Coweta",2020,150849,148509,2340,1.57566208108599
"919","Coweta",2021,149956,150849,-893,-0.591982711188009
"920","Coweta",2022,152882,149956,2926,1.9512390301155
"921","Crawford",2000,12408,12369,39,0.315304390007276
"922","Crawford",2001,12496,12408,88,0.709219858156028
"923","Crawford",2002,12553,12496,57,0.456145966709347
"924","Crawford",2003,12592,12553,39,0.310682705329403
"925","Crawford",2004,12784,12592,192,1.52477763659466
"926","Crawford",2005,12875,12784,91,0.711827284105131
"927","Crawford",2006,12943,12875,68,0.528155339805825
"928","Crawford",2007,12895,12943,-48,-0.370856833809781
"929","Crawford",2008,12967,12895,72,0.558355951919349
"930","Crawford",2009,12711,12967,-256,-1.9742423073957
"931","Crawford",2010,12591,12711,-120,-0.944064196365353
"932","Crawford",2011,12567,12591,-24,-0.190612342149154
"933","Crawford",2012,12600,12567,33,0.262592504177608
"934","Crawford",2013,12504,12600,-96,-0.761904761904762
"935","Crawford",2014,12387,12504,-117,-0.935700575815739
"936","Crawford",2015,12388,12387,1,0.00807297973682086
"937","Crawford",2016,12322,12388,-66,-0.532773651921214
"938","Crawford",2017,12295,12322,-27,-0.219120272683006
"939","Crawford",2018,12318,12295,23,0.187067913786092
"940","Crawford",2019,12404,12318,86,0.698165286572496
"941","Crawford",2020,12231,12404,-173,-1.3947113834247
"942","Crawford",2021,12153,12231,-78,-0.637723816531764
"943","Crawford",2022,12140,12153,-13,-0.106969472558216
"944","Crisp",2000,22018,21895,123,0.561772094085408
"945","Crisp",2001,22184,22018,166,0.753928603869561
"946","Crisp",2002,22284,22184,100,0.450775333573747
"947","Crisp",2003,22194,22284,-90,-0.403877221324717
"948","Crisp",2004,22320,22194,126,0.56772100567721
"949","Crisp",2005,22456,22320,136,0.609318996415771
"950","Crisp",2006,22718,22456,262,1.16672604203776
"951","Crisp",2007,23146,22718,428,1.88396865921296
"952","Crisp",2008,23243,23146,97,0.41907889052104
"953","Crisp",2009,23378,23243,135,0.580820031837542
"954","Crisp",2010,23423,23378,45,0.192488664556421
"955","Crisp",2011,23710,23423,287,1.22529138026726
"956","Crisp",2012,23606,23710,-104,-0.438633487979755
"957","Crisp",2013,23336,23606,-270,-1.14377700584597
"958","Crisp",2014,22934,23336,-402,-1.72266026739801
"959","Crisp",2015,22881,22934,-53,-0.231097933199616
"960","Crisp",2016,22721,22881,-160,-0.69927013679472
"961","Crisp",2017,22736,22721,15,0.066018221029004
"962","Crisp",2018,22601,22736,-135,-0.593771991555243
"963","Crisp",2019,22372,22601,-229,-1.01322950311933
"964","Crisp",2020,22034,22372,-338,-1.51081709279456
"965","Crisp",2021,19879,22034,-2155,-9.78033947535627
"966","Crisp",2022,19708,19879,-171,-0.860204235625534
"967","Dade",2000,15199,15029,170,1.13114645019629
"968","Dade",2001,15520,15199,321,2.11198105138496
"969","Dade",2002,15658,15520,138,0.889175257731959
"970","Dade",2003,15901,15658,243,1.55192234001788
"971","Dade",2004,16028,15901,127,0.798691906169423
"972","Dade",2005,16188,16028,160,0.998253057149987
"973","Dade",2006,16411,16188,223,1.3775636273783
"974","Dade",2007,16648,16411,237,1.44415331180306
"975","Dade",2008,16651,16648,3,0.0180201826045171
"976","Dade",2009,16657,16651,6,0.0360338718395292
"977","Dade",2010,16609,16657,-48,-0.288167136939425
"978","Dade",2011,16570,16609,-39,-0.234812451080739
"979","Dade",2012,16490,16570,-80,-0.482800241400121
"980","Dade",2013,16507,16490,17,0.103092783505155
"981","Dade",2014,16389,16507,-118,-0.714848246198582
"982","Dade",2015,16264,16389,-125,-0.762706693513942
"983","Dade",2016,16257,16264,-7,-0.0430398425971471
"984","Dade",2017,16285,16257,28,0.172233499415636
"985","Dade",2018,16226,16285,-59,-0.362296591955788
"986","Dade",2019,16116,16226,-110,-0.677924318994207
"987","Dade",2020,16057,16116,-59,-0.366095805410772
"988","Dade",2021,16326,16057,269,1.67528180855702
"989","Dade",2022,16081,16326,-245,-1.50067377189759
"990","Dawson",2000,16238,15203,1035,6.80786686838124
"991","Dawson",2001,16875,16238,637,3.92289690848627
"992","Dawson",2002,17521,16875,646,3.82814814814815
"993","Dawson",2003,18406,17521,885,5.05108155927173
"994","Dawson",2004,18831,18406,425,2.30902966423992
"995","Dawson",2005,19611,18831,780,4.14210610164091
"996","Dawson",2006,20660,19611,1049,5.34903880475243
"997","Dawson",2007,21509,20660,849,4.10939012584705
"998","Dawson",2008,21951,21509,442,2.05495374029476
"999","Dawson",2009,22325,21951,374,1.70379481572594
"1000","Dawson",2010,22343,22325,18,0.0806270996640538
"1001","Dawson",2011,22459,22343,116,0.519178266123618
"1002","Dawson",2012,22422,22459,-37,-0.164744645799012
"1003","Dawson",2013,22686,22422,264,1.17741503880118
"1004","Dawson",2014,22957,22686,271,1.19456933791766
"1005","Dawson",2015,23312,22957,355,1.54636929912445
"1006","Dawson",2016,23604,23312,292,1.25257378174331
"1007","Dawson",2017,24379,23604,775,3.28334180647348
"1008","Dawson",2018,25083,24379,704,2.88773124410353
"1009","Dawson",2019,26108,25083,1025,4.08643304229957
"1010","Dawson",2020,27113,26108,1005,3.84939482151065
"1011","Dawson",2021,28497,27113,1384,5.1045623870468
"1012","Dawson",2022,30138,28497,1641,5.75850089483103
"1013","DeKalb",2000,668271,656625,11646,1.7736150770988
"1014","DeKalb",2001,670900,668271,2629,0.393403275018668
"1015","DeKalb",2002,669789,670900,-1111,-0.165598449843494
"1016","DeKalb",2003,668148,669789,-1641,-0.245002530647711
"1017","DeKalb",2004,666204,668148,-1944,-0.290953501320067
"1018","DeKalb",2005,668998,666204,2794,0.419391057393831
"1019","DeKalb",2006,676687,668998,7689,1.14933079022658
"1020","DeKalb",2007,680962,676687,4275,0.631754415261413
"1021","DeKalb",2008,685646,680962,4684,0.687850423371642
"1022","DeKalb",2009,690658,685646,5012,0.730989461033828
"1023","DeKalb",2010,692902,690658,2244,0.32490755192874
"1024","DeKalb",2011,699893,692902,6991,1.00894498789151
"1025","DeKalb",2012,707089,699893,7196,1.02815716116606
"1026","DeKalb",2013,713340,707089,6251,0.884047128437863
"1027","DeKalb",2014,722161,713340,8821,1.2365772282502
"1028","DeKalb",2015,734871,722161,12710,1.7599953472979
"1029","DeKalb",2016,740321,734871,5450,0.741626761703755
"1030","DeKalb",2017,753253,740321,12932,1.74680982979005
"1031","DeKalb",2018,756558,753253,3305,0.438763602667364
"1032","DeKalb",2019,759297,756558,2739,0.362034371455989
"1033","DeKalb",2020,762009,759297,2712,0.357172489816238
"1034","DeKalb",2021,757718,762009,-4291,-0.563116708595305
"1035","DeKalb",2022,762820,757718,5102,0.67333757413708
"1036","Decatur",2000,28223,28063,160,0.570145743505684
"1037","Decatur",2001,27870,28223,-353,-1.25075293200581
"1038","Decatur",2002,27892,27870,22,0.0789379260853965
"1039","Decatur",2003,27795,27892,-97,-0.347769969883838
"1040","Decatur",2004,27763,27795,-32,-0.115128620255442
"1041","Decatur",2005,27511,27763,-252,-0.907682887296041
"1042","Decatur",2006,27835,27511,324,1.17771073388826
"1043","Decatur",2007,27883,27835,48,0.1724447637866
"1044","Decatur",2008,28010,27883,127,0.455474661980418
"1045","Decatur",2009,28058,28010,48,0.171367368796858
"1046","Decatur",2010,27813,28058,-245,-0.873191246703258
"1047","Decatur",2011,27694,27813,-119,-0.42785747671952
"1048","Decatur",2012,27509,27694,-185,-0.668014732433018
"1049","Decatur",2013,27359,27509,-150,-0.545276091460976
"1050","Decatur",2014,27220,27359,-139,-0.508059505098871
"1051","Decatur",2015,27174,27220,-46,-0.168993387215283
"1052","Decatur",2016,26822,27174,-352,-1.29535585486126
"1053","Decatur",2017,26716,26822,-106,-0.395197971814182
"1054","Decatur",2018,26575,26716,-141,-0.52777361880521
"1055","Decatur",2019,26404,26575,-171,-0.64346190028222
"1056","Decatur",2020,26457,26404,53,0.200727162551129
"1057","Decatur",2021,29038,26457,2581,9.75545224326265
"1058","Decatur",2022,28982,29038,-56,-0.192850747296646
"1059","Dodge",2000,19168,19139,29,0.151523068080882
"1060","Dodge",2001,19513,19168,345,1.79987479131886
"1061","Dodge",2002,19771,19513,258,1.3221954594373
"1062","Dodge",2003,20180,19771,409,2.06868645996662
"1063","Dodge",2004,20319,20180,139,0.688800792864222
"1064","Dodge",2005,20550,20319,231,1.13686697179979
"1065","Dodge",2006,20954,20550,404,1.96593673965937
"1066","Dodge",2007,21225,20954,271,1.2933091533836
"1067","Dodge",2008,21399,21225,174,0.819787985865724
"1068","Dodge",2009,21659,21399,260,1.21501004719847
"1069","Dodge",2010,21775,21659,116,0.535574126229281
"1070","Dodge",2011,21894,21775,119,0.546498277841561
"1071","Dodge",2012,21329,21894,-565,-2.58061569379739
"1072","Dodge",2013,21221,21329,-108,-0.50635285292325
"1073","Dodge",2014,20976,21221,-245,-1.15451675227369
"1074","Dodge",2015,20882,20976,-94,-0.448131197559115
"1075","Dodge",2016,20563,20882,-319,-1.52763145292596
"1076","Dodge",2017,20730,20563,167,0.812138306667315
"1077","Dodge",2018,20705,20730,-25,-0.120598166907863
"1078","Dodge",2019,20605,20705,-100,-0.482975126780971
"1079","Dodge",2020,20452,20605,-153,-0.742538218878913
"1080","Dodge",2021,19759,20452,-693,-3.3884216702523
"1081","Dodge",2022,19802,19759,43,0.217622349309176
"1082","Dooly",2000,11519,11461,58,0.506064043277201
"1083","Dooly",2001,12040,11519,521,4.52296206267905
"1084","Dooly",2002,12207,12040,167,1.38704318936877
"1085","Dooly",2003,12508,12207,301,2.46579831244368
"1086","Dooly",2004,12848,12508,340,2.71826031339942
"1087","Dooly",2005,13292,12848,444,3.45579078455791
"1088","Dooly",2006,13719,13292,427,3.21245862172736
"1089","Dooly",2007,13867,13719,148,1.0787958305999
"1090","Dooly",2008,14191,13867,324,2.33648229609865
"1091","Dooly",2009,14769,14191,578,4.07300401663026
"1092","Dooly",2010,14869,14769,100,0.677093912925723
"1093","Dooly",2011,14587,14869,-282,-1.89656331965835
"1094","Dooly",2012,14318,14587,-269,-1.84410776718996
"1095","Dooly",2013,14304,14318,-14,-0.0977790194161196
"1096","Dooly",2014,14188,14304,-116,-0.810961968680089
"1097","Dooly",2015,14035,14188,-153,-1.07837609247251
"1098","Dooly",2016,13763,14035,-272,-1.9380121125757
"1099","Dooly",2017,13737,13763,-26,-0.188912301097145
"1100","Dooly",2018,13706,13737,-31,-0.225667904200335
"1101","Dooly",2019,13390,13706,-316,-2.3055596089304
"1102","Dooly",2020,13174,13390,-216,-1.61314413741598
"1103","Dooly",2021,10885,13174,-2289,-17.375132837407
"1104","Dooly",2022,10572,10885,-313,-2.87551676619201
"1105","Dougherty",2000,95859,96199,-340,-0.353434027380742
"1106","Dougherty",2001,95944,95859,85,0.088671903524969
"1107","Dougherty",2002,95429,95944,-515,-0.536771450012507
"1108","Dougherty",2003,95015,95429,-414,-0.43383038698928
"1109","Dougherty",2004,94596,95015,-419,-0.440983002683787
"1110","Dougherty",2005,94610,94596,14,0.0147997801175525
"1111","Dougherty",2006,94418,94610,-192,-0.202938378606913
"1112","Dougherty",2007,94522,94418,104,0.110148488635642
"1113","Dougherty",2008,94363,94522,-159,-0.168214807134847
"1114","Dougherty",2009,94688,94363,325,0.344414654048727
"1115","Dougherty",2010,94577,94688,-111,-0.117227103751267
"1116","Dougherty",2011,94788,94577,211,0.223098639204035
"1117","Dougherty",2012,94501,94788,-287,-0.302780942735367
"1118","Dougherty",2013,92969,94501,-1532,-1.62114686617073
"1119","Dougherty",2014,92407,92969,-562,-0.604502576127526
"1120","Dougherty",2015,91332,92407,-1075,-1.16333178222429
"1121","Dougherty",2016,90017,91332,-1315,-1.43980204090571
"1122","Dougherty",2017,89502,90017,-515,-0.572114156214937
"1123","Dougherty",2018,91243,89502,1741,1.94520792831445
"1124","Dougherty",2019,87956,91243,-3287,-3.60246813454183
"1125","Dougherty",2020,86477,87956,-1479,-1.68152257947155
"1126","Dougherty",2021,84844,86477,-1633,-1.88836337985823
"1127","Dougherty",2022,82966,84844,-1878,-2.21347414077601
"1128","Douglas",2000,92774,90955,1819,1.99989005552196
"1129","Douglas",2001,95720,92774,2946,3.17545864142971
"1130","Douglas",2002,98582,95720,2862,2.98997074801504
"1131","Douglas",2003,102034,98582,3452,3.50165344586233
"1132","Douglas",2004,107377,102034,5343,5.23648979751847
"1133","Douglas",2005,113354,107377,5977,5.56636896169571
"1134","Douglas",2006,119918,113354,6564,5.79070875310973
"1135","Douglas",2007,125560,119918,5642,4.70488166914058
"1136","Douglas",2008,129508,125560,3948,3.14431347562918
"1137","Douglas",2009,131292,129508,1784,1.37752107977886
"1138","Douglas",2010,132722,131292,1430,1.08917527343631
"1139","Douglas",2011,133355,132722,633,0.476936755021775
"1140","Douglas",2012,133971,133355,616,0.461924937197705
"1141","Douglas",2013,136379,133971,2408,1.79740391577282
"1142","Douglas",2014,138776,136379,2397,1.75760197684394
"1143","Douglas",2015,140733,138776,1957,1.41018619934283
"1144","Douglas",2016,142224,140733,1491,1.05945300675748
"1145","Douglas",2017,143882,142224,1658,1.16576667791653
"1146","Douglas",2018,145331,143882,1449,1.00707524221237
"1147","Douglas",2019,146343,145331,1012,0.69634145502336
"1148","Douglas",2020,147988,146343,1645,1.12407153058226
"1149","Douglas",2021,145814,147988,-2174,-1.46903803011055
"1150","Douglas",2022,147316,145814,1502,1.03007941624261
"1151","Early",2000,12303,12311,-8,-0.0649825359434652
"1152","Early",2001,12207,12303,-96,-0.780297488417459
"1153","Early",2002,12047,12207,-160,-1.31072335545179
"1154","Early",2003,11978,12047,-69,-0.572756702913588
"1155","Early",2004,11800,11978,-178,-1.48605777258307
"1156","Early",2005,11749,11800,-51,-0.432203389830508
"1157","Early",2006,11648,11749,-101,-0.859647629585497
"1158","Early",2007,11429,11648,-219,-1.8801510989011
"1159","Early",2008,11262,11429,-167,-1.46119520517981
"1160","Early",2009,11101,11262,-161,-1.42958621914402
"1161","Early",2010,10988,11101,-113,-1.01792631294478
"1162","Early",2011,10778,10988,-210,-1.91117582817619
"1163","Early",2012,10594,10778,-184,-1.70718129523103
"1164","Early",2013,10542,10594,-52,-0.490843873890882
"1165","Early",2014,10491,10542,-51,-0.483779169038133
"1166","Early",2015,10575,10491,84,0.800686302545039
"1167","Early",2016,10339,10575,-236,-2.23167848699764
"1168","Early",2017,10296,10339,-43,-0.415900957539414
"1169","Early",2018,10247,10296,-49,-0.475912975912976
"1170","Early",2019,10190,10247,-57,-0.556260368888455
"1171","Early",2020,10037,10190,-153,-1.50147203140334
"1172","Early",2021,10619,10037,582,5.79854538208628
"1173","Early",2022,10574,10619,-45,-0.423768716451643
"1174","Echols",2000,3782,3553,229,6.44525752884886
"1175","Echols",2001,3774,3782,-8,-0.211528291909043
"1176","Echols",2002,3751,3774,-23,-0.609432962374139
"1177","Echols",2003,3844,3751,93,2.47933884297521
"1178","Echols",2004,3926,3844,82,2.13319458896982
"1179","Echols",2005,3946,3926,20,0.509424350483953
"1180","Echols",2006,3913,3946,-33,-0.836289913836797
"1181","Echols",2007,3938,3913,25,0.638895987733197
"1182","Echols",2008,3954,3938,16,0.406297613001524
"1183","Echols",2009,4012,3954,58,1.46686899342438
"1184","Echols",2010,4050,4012,38,0.94715852442672
"1185","Echols",2011,4129,4050,79,1.95061728395062
"1186","Echols",2012,3988,4129,-141,-3.41487042867522
"1187","Echols",2013,4057,3988,69,1.73019057171515
"1188","Echols",2014,4003,4057,-54,-1.33103278284447
"1189","Echols",2015,4040,4003,37,0.924306769922558
"1190","Echols",2016,3962,4040,-78,-1.93069306930693
"1191","Echols",2017,3936,3962,-26,-0.656234225138819
"1192","Echols",2018,4000,3936,64,1.6260162601626
"1193","Echols",2019,4006,4000,6,0.15
"1194","Echols",2020,4002,4006,-4,-0.0998502246630055
"1195","Echols",2021,3699,4002,-303,-7.5712143928036
"1196","Echols",2022,3686,3699,-13,-0.351446336847797
"1197","Effingham",2000,37755,36838,917,2.48927737662197
"1198","Effingham",2001,39116,37755,1361,3.60482055356906
"1199","Effingham",2002,40757,39116,1641,4.19521423458431
"1200","Effingham",2003,42168,40757,1411,3.46198199082366
"1201","Effingham",2004,43674,42168,1506,3.57142857142857
"1202","Effingham",2005,45729,43674,2055,4.70531666437697
"1203","Effingham",2006,47823,45729,2094,4.57915108574428
"1204","Effingham",2007,49660,47823,1837,3.84124793509399
"1205","Effingham",2008,50738,49660,1078,2.17076117599678
"1206","Effingham",2009,51908,50738,1170,2.30596397177658
"1207","Effingham",2010,52436,51908,528,1.01718424905602
"1208","Effingham",2011,52655,52436,219,0.417651994812724
"1209","Effingham",2012,53293,52655,638,1.21166081093913
"1210","Effingham",2013,54456,53293,1163,2.18227534573021
"1211","Effingham",2014,55423,54456,967,1.77574555604525
"1212","Effingham",2015,57106,55423,1683,3.03664543601032
"1213","Effingham",2016,58712,57106,1606,2.81231394249291
"1214","Effingham",2017,59982,58712,1270,2.16310123995095
"1215","Effingham",2018,62190,59982,2208,3.68110433129939
"1216","Effingham",2019,64296,62190,2106,3.38639652677279
"1217","Effingham",2020,65765,64296,1469,2.28474555182282
"1218","Effingham",2021,66741,65765,976,1.48407207481183
"1219","Effingham",2022,69041,66741,2300,3.4461575343492
"1220","Elbert",2000,20464,20425,39,0.19094247246022
"1221","Elbert",2001,20544,20464,80,0.390930414386239
"1222","Elbert",2002,20610,20544,66,0.321261682242991
"1223","Elbert",2003,20572,20610,-38,-0.184376516254246
"1224","Elbert",2004,20693,20572,121,0.588178106163718
"1225","Elbert",2005,20593,20693,-100,-0.483255207074856
"1226","Elbert",2006,20631,20593,38,0.184528723352596
"1227","Elbert",2007,20551,20631,-80,-0.387765983229121
"1228","Elbert",2008,20477,20551,-74,-0.360079801469515
"1229","Elbert",2009,20335,20477,-142,-0.693460956194755
"1230","Elbert",2010,20112,20335,-223,-1.0966314236538
"1231","Elbert",2011,19886,20112,-226,-1.12370723945903
"1232","Elbert",2012,19684,19886,-202,-1.0157900030172
"1233","Elbert",2013,19599,19684,-85,-0.431822800243853
"1234","Elbert",2014,19438,19599,-161,-0.821470483187918
"1235","Elbert",2015,19364,19438,-74,-0.380697602634016
"1236","Elbert",2016,19143,19364,-221,-1.14129312125594
"1237","Elbert",2017,19109,19143,-34,-0.177610614846158
"1238","Elbert",2018,19120,19109,11,0.0575644984038935
"1239","Elbert",2019,19194,19120,74,0.387029288702929
"1240","Elbert",2020,19335,19194,141,0.734604563926227
"1241","Elbert",2021,19579,19335,244,1.26196017584691
"1242","Elbert",2022,19814,19579,235,1.2002655906839
"1243","Emanuel",2000,21851,21784,67,0.307565185457216
"1244","Emanuel",2001,21683,21851,-168,-0.768843531188504
"1245","Emanuel",2002,21511,21683,-172,-0.793248166766591
"1246","Emanuel",2003,21616,21511,105,0.488122356003905
"1247","Emanuel",2004,21579,21616,-37,-0.171169504071058
"1248","Emanuel",2005,21777,21579,198,0.917558737661615
"1249","Emanuel",2006,22091,21777,314,1.44188823070212
"1250","Emanuel",2007,22109,22091,18,0.0814811461681228
"1251","Emanuel",2008,22421,22109,312,1.41119001311683
"1252","Emanuel",2009,22456,22421,35,0.156103652825476
"1253","Emanuel",2010,22664,22456,208,0.926255789098682
"1254","Emanuel",2011,22567,22664,-97,-0.427991528415108
"1255","Emanuel",2012,22898,22567,331,1.4667434749856
"1256","Emanuel",2013,22867,22898,-31,-0.135383002882348
"1257","Emanuel",2014,22755,22867,-112,-0.489788778589233
"1258","Emanuel",2015,22708,22755,-47,-0.20654801142606
"1259","Emanuel",2016,22635,22708,-73,-0.321472608772239
"1260","Emanuel",2017,22530,22635,-105,-0.46388336646786
"1261","Emanuel",2018,22612,22530,82,0.363959165557035
"1262","Emanuel",2019,22646,22612,34,0.150362639306563
"1263","Emanuel",2020,22507,22646,-139,-0.613794930672083
"1264","Emanuel",2021,22716,22507,209,0.928599991113876
"1265","Emanuel",2022,22929,22716,213,0.937665081880613
"1266","Evans",2000,10531,10289,242,2.35202643599961
"1267","Evans",2001,10691,10531,160,1.51932390086412
"1268","Evans",2002,10885,10691,194,1.81461041997942
"1269","Evans",2003,11020,10885,135,1.24023886081764
"1270","Evans",2004,10889,11020,-131,-1.18874773139746
"1271","Evans",2005,10895,10889,6,0.0551014785563413
"1272","Evans",2006,10889,10895,-6,-0.0550711335474989
"1273","Evans",2007,10899,10889,10,0.0918357975939021
"1274","Evans",2008,11020,10899,121,1.11019359574273
"1275","Evans",2009,11016,11020,-4,-0.0362976406533575
"1276","Evans",2010,11007,11016,-9,-0.0816993464052288
"1277","Evans",2011,11065,11007,58,0.526937403470519
"1278","Evans",2012,10689,11065,-376,-3.39810212381383
"1279","Evans",2013,10833,10689,144,1.34717934325007
"1280","Evans",2014,10898,10833,65,0.600018462106526
"1281","Evans",2015,10787,10898,-111,-1.01853551110295
"1282","Evans",2016,10670,10787,-117,-1.08463891721517
"1283","Evans",2017,10775,10670,105,0.98406747891284
"1284","Evans",2018,10721,10775,-54,-0.501160092807425
"1285","Evans",2019,10654,10721,-67,-0.624941703199328
"1286","Evans",2020,10638,10654,-16,-0.15017833677492
"1287","Evans",2021,10672,10638,34,0.319608949050573
"1288","Evans",2022,10695,10672,23,0.21551724137931
"1289","Fannin",2000,19954,19443,511,2.62819523736049
"1290","Fannin",2001,20412,19954,458,2.29527914202666
"1291","Fannin",2002,21041,20412,629,3.08152067411327
"1292","Fannin",2003,21424,21041,383,1.82025569126943
"1293","Fannin",2004,21873,21424,449,2.09578043315907
"1294","Fannin",2005,22174,21873,301,1.37612581721757
"1295","Fannin",2006,22758,22174,584,2.63371516190133
"1296","Fannin",2007,23185,22758,427,1.87626329202918
"1297","Fannin",2008,23416,23185,231,0.996333836532241
"1298","Fannin",2009,23661,23416,245,1.04629313290058
"1299","Fannin",2010,23663,23661,2,0.00845272811800009
"1300","Fannin",2011,23708,23663,45,0.190170308075899
"1301","Fannin",2012,23492,23708,-216,-0.911084865868061
"1302","Fannin",2013,23760,23492,268,1.14081389409161
"1303","Fannin",2014,23753,23760,-7,-0.0294612794612795
"1304","Fannin",2015,24303,23753,550,2.31549698985391
"1305","Fannin",2016,24900,24303,597,2.45648685347488
"1306","Fannin",2017,25322,24900,422,1.69477911646586
"1307","Fannin",2018,25964,25322,642,2.53534475949767
"1308","Fannin",2019,26188,25964,224,0.862733014943768
"1309","Fannin",2020,26521,26188,333,1.27157476706889
"1310","Fannin",2021,25817,26521,-704,-2.65450020738283
"1311","Fannin",2022,25737,25817,-80,-0.309873339272572
"1312","Fayette",2000,92073,89342,2731,3.05679299769425
"1313","Fayette",2001,94086,92073,2013,2.18630868984393
"1314","Fayette",2002,95707,94086,1621,1.72289182237527
"1315","Fayette",2003,97634,95707,1927,2.01343684370004
"1316","Fayette",2004,99443,97634,1809,1.85283815064424
"1317","Fayette",2005,101961,99443,2518,2.53210381826775
"1318","Fayette",2006,104099,101961,2138,2.09688017967654
"1319","Fayette",2007,104989,104099,890,0.854955379014208
"1320","Fayette",2008,105192,104989,203,0.193353589423654
"1321","Fayette",2009,105493,105192,301,0.286143432960681
"1322","Fayette",2010,106945,105493,1452,1.37639464229854
"1323","Fayette",2011,107784,106945,839,0.784515405114779
"1324","Fayette",2012,107524,107784,-260,-0.241223187114971
"1325","Fayette",2013,108365,107524,841,0.782150961645772
"1326","Fayette",2014,109664,108365,1299,1.19872652609237
"1327","Fayette",2015,110714,109664,1050,0.957470090458127
"1328","Fayette",2016,111627,110714,913,0.82464728941236
"1329","Fayette",2017,112549,111627,922,0.825965044299318
"1330","Fayette",2018,113459,112549,910,0.80853672622591
"1331","Fayette",2019,114421,113459,962,0.847883376373844
"1332","Fayette",2020,115821,114421,1400,1.22355162076891
"1333","Fayette",2021,120574,115821,4753,4.103746298167
"1334","Fayette",2022,122030,120574,1456,1.20755718479938
"1335","Floyd",2000,90837,89659,1178,1.31386698490949
"1336","Floyd",2001,91181,90837,344,0.378700309345311
"1337","Floyd",2002,92597,91181,1416,1.55295511126221
"1338","Floyd",2003,93539,92597,942,1.01731157596898
"1339","Floyd",2004,94014,93539,475,0.507809576754081
"1340","Floyd",2005,94332,94014,318,0.338247495053928
"1341","Floyd",2006,95165,94332,833,0.883051350549124
"1342","Floyd",2007,95308,95165,143,0.150265328639731
"1343","Floyd",2008,95922,95308,614,0.644227137281236
"1344","Floyd",2009,96383,95922,461,0.480598819874481
"1345","Floyd",2010,96274,96383,-109,-0.113090482761483
"1346","Floyd",2011,95989,96274,-285,-0.296030080811019
"1347","Floyd",2012,96177,95989,188,0.195855775140902
"1348","Floyd",2013,95821,96177,-356,-0.370150867671065
"1349","Floyd",2014,96063,95821,242,0.252554241763288
"1350","Floyd",2015,96504,96063,441,0.459073732862809
"1351","Floyd",2016,96560,96504,56,0.0580286827489016
"1352","Floyd",2017,97613,96560,1053,1.09051367025684
"1353","Floyd",2018,97927,97613,314,0.321678464958561
"1354","Floyd",2019,98498,97927,571,0.583087401840146
"1355","Floyd",2020,98604,98498,106,0.107616398302504
"1356","Floyd",2021,98771,98604,167,0.169364325990832
"1357","Floyd",2022,99443,98771,672,0.680361644612285
"1358","Forsyth",2000,100400,93244,7156,7.67448843893441
"1359","Forsyth",2001,108491,100400,8091,8.05876494023904
"1360","Forsyth",2002,115797,108491,7306,6.73419915015992
"1361","Forsyth",2003,122698,115797,6901,5.95956717358826
"1362","Forsyth",2004,129639,122698,6941,5.65697892386184
"1363","Forsyth",2005,137643,129639,8004,6.17406798879967
"1364","Forsyth",2006,147228,137643,9585,6.96366687735664
"1365","Forsyth",2007,157129,147228,9901,6.72494362485397
"1366","Forsyth",2008,166338,157129,9209,5.86078954235055
"1367","Forsyth",2009,171993,166338,5655,3.39970421671536
"1368","Forsyth",2010,176738,171993,4745,2.75883320832825
"1369","Forsyth",2011,181840,176738,5102,2.88675893129944
"1370","Forsyth",2012,187928,181840,6088,3.34799824021117
"1371","Forsyth",2013,195405,187928,7477,3.9786513984079
"1372","Forsyth",2014,204302,195405,8897,4.5531076482178
"1373","Forsyth",2015,212438,204302,8136,3.98233986940901
"1374","Forsyth",2016,221009,212438,8571,4.03458891535413
"1375","Forsyth",2017,227967,221009,6958,3.14828807876602
"1376","Forsyth",2018,236612,227967,8645,3.7922155399685
"1377","Forsyth",2019,244252,236612,7640,3.22891484793671
"1378","Forsyth",2020,250847,244252,6595,2.70008024499288
"1379","Forsyth",2021,260206,250847,9359,3.73095950918289
"1380","Forsyth",2022,267237,260206,7031,2.70208988263145
"1381","Franklin",2000,20314,20021,293,1.46346336346836
"1382","Franklin",2001,20703,20314,389,1.91493551245446
"1383","Franklin",2002,20942,20703,239,1.15442206443511
"1384","Franklin",2003,21193,20942,251,1.19854837169325
"1385","Franklin",2004,21430,21193,237,1.11829377624687
"1386","Franklin",2005,21725,21430,295,1.376574895007
"1387","Franklin",2006,21956,21725,231,1.06329113924051
"1388","Franklin",2007,22195,21956,239,1.08854071779923
"1389","Franklin",2008,22254,22195,59,0.265825636404596
"1390","Franklin",2009,22152,22254,-102,-0.458344567268806
"1391","Franklin",2010,22048,22152,-104,-0.469483568075117
"1392","Franklin",2011,21864,22048,-184,-0.834542815674891
"1393","Franklin",2012,21894,21864,30,0.137211855104281
"1394","Franklin",2013,22009,21894,115,0.52525806156938
"1395","Franklin",2014,22264,22009,255,1.15861692943796
"1396","Franklin",2015,22311,22264,47,0.211103126122889
"1397","Franklin",2016,22320,22311,9,0.0403388463089956
"1398","Franklin",2017,22820,22320,500,2.24014336917563
"1399","Franklin",2018,23023,22820,203,0.889570552147239
"1400","Franklin",2019,23349,23023,326,1.41597532901881
"1401","Franklin",2020,23504,23349,155,0.663839993147458
"1402","Franklin",2021,23785,23504,281,1.19554118447924
"1403","Franklin",2022,24128,23785,343,1.44208534790835
"1404","Fulton",2000,816190,807365,8825,1.09306199798109
"1405","Fulton",2001,820213,816190,4023,0.492899937514549
"1406","Fulton",2002,815224,820213,-4989,-0.608256635776317
"1407","Fulton",2003,812568,815224,-2656,-0.32580002551446
"1408","Fulton",2004,809481,812568,-3087,-0.379906666272853
"1409","Fulton",2005,818737,809481,9256,1.14344870355203
"1410","Fulton",2006,845181,818737,26444,3.22985280987668
"1411","Fulton",2007,869329,845181,24148,2.85713947663282
"1412","Fulton",2008,888694,869329,19365,2.22758012214018
"1413","Fulton",2009,905511,888694,16817,1.89232739278087
"1414","Fulton",2010,926197,905511,20686,2.28445595912142
"1415","Fulton",2011,949599,926197,23402,2.52667629024927
"1416","Fulton",2012,977773,949599,28174,2.966936570068
"1417","Fulton",2013,984293,977773,6520,0.666821440150219
"1418","Fulton",2014,996319,984293,12026,1.22179066599072
"1419","Fulton",2015,1010562,996319,14243,1.4295622185264
"1420","Fulton",2016,1023336,1010562,12774,1.26404911326569
"1421","Fulton",2017,1041423,1023336,18087,1.76745467764253
"1422","Fulton",2018,1050114,1041423,8691,0.834531213541472
"1423","Fulton",2019,1063937,1050114,13823,1.31633327429212
"1424","Fulton",2020,1077402,1063937,13465,1.26558245460023
"1425","Fulton",2021,1065334,1077402,-12068,-1.12010187469487
"1426","Fulton",2022,1074634,1065334,9300,0.872965661473303
"1427","Gilmer",2000,23634,22357,1277,5.71185758375453
"1428","Gilmer",2001,24229,23634,595,2.51755944825252
"1429","Gilmer",2002,24920,24229,691,2.85195426967683
"1430","Gilmer",2003,25575,24920,655,2.62841091492777
"1431","Gilmer",2004,26175,25575,600,2.34604105571848
"1432","Gilmer",2005,26808,26175,633,2.41833810888252
"1433","Gilmer",2006,27665,26808,857,3.19680692330648
"1434","Gilmer",2007,27996,27665,331,1.19645761792879
"1435","Gilmer",2008,28211,27996,215,0.767966852407487
"1436","Gilmer",2009,28174,28211,-37,-0.13115451419659
"1437","Gilmer",2010,28335,28174,161,0.571448853552921
"1438","Gilmer",2011,28324,28335,-11,-0.0388212458090701
"1439","Gilmer",2012,28190,28324,-134,-0.473097020194888
"1440","Gilmer",2013,28579,28190,389,1.37992195814118
"1441","Gilmer",2014,28829,28579,250,0.874768186430596
"1442","Gilmer",2015,29400,28829,571,1.98064448992334
"1443","Gilmer",2016,29733,29400,333,1.13265306122449
"1444","Gilmer",2017,30674,29733,941,3.16483368647631
"1445","Gilmer",2018,30816,30674,142,0.462932776944644
"1446","Gilmer",2019,31369,30816,553,1.79452232606438
"1447","Gilmer",2020,31978,31369,609,1.94140712168064
"1448","Gilmer",2021,32026,31978,48,0.150103195947214
"1449","Gilmer",2022,32407,32026,381,1.18965840254793
"1450","Glascock",2000,2574,2562,12,0.468384074941452
"1451","Glascock",2001,2586,2574,12,0.466200466200466
"1452","Glascock",2002,2618,2586,32,1.23743232791957
"1453","Glascock",2003,2644,2618,26,0.993124522536287
"1454","Glascock",2004,2720,2644,76,2.87443267776097
"1455","Glascock",2005,2763,2720,43,1.58088235294118
"1456","Glascock",2006,2893,2763,130,4.70503076366269
"1457","Glascock",2007,2988,2893,95,3.28378845489112
"1458","Glascock",2008,3010,2988,22,0.736278447121821
"1459","Glascock",2009,3066,3010,56,1.86046511627907
"1460","Glascock",2010,3080,3066,14,0.45662100456621
"1461","Glascock",2011,3084,3080,4,0.12987012987013
"1462","Glascock",2012,3142,3084,58,1.88067444876783
"1463","Glascock",2013,3102,3142,-40,-1.27307447485678
"1464","Glascock",2014,3053,3102,-49,-1.57962604771115
"1465","Glascock",2015,3065,3053,12,0.393056010481494
"1466","Glascock",2016,3006,3065,-59,-1.92495921696574
"1467","Glascock",2017,3062,3006,56,1.86294078509647
"1468","Glascock",2018,2995,3062,-67,-2.18811234487263
"1469","Glascock",2019,2971,2995,-24,-0.801335559265442
"1470","Glascock",2020,2984,2971,13,0.437563110063952
"1471","Glascock",2021,2919,2984,-65,-2.17828418230563
"1472","Glascock",2022,2939,2919,20,0.685166152792052
"1473","Glynn",2000,67696,67426,270,0.400438999792365
"1474","Glynn",2001,68558,67696,862,1.27333963601985
"1475","Glynn",2002,69408,68558,850,1.23982613261764
"1476","Glynn",2003,70391,69408,983,1.4162632549562
"1477","Glynn",2004,71475,70391,1084,1.53996959838616
"1478","Glynn",2005,72589,71475,1114,1.55858691850297
"1479","Glynn",2006,74870,72589,2281,3.14234939178112
"1480","Glynn",2007,76513,74870,1643,2.19447041538667
"1481","Glynn",2008,78013,76513,1500,1.96045116516148
"1482","Glynn",2009,78946,78013,933,1.19595452040045
"1483","Glynn",2010,79816,78946,870,1.10201910166443
"1484","Glynn",2011,80386,79816,570,0.714142527813972
"1485","Glynn",2012,81022,80386,636,0.791182544224118
"1486","Glynn",2013,81508,81022,486,0.599837081286564
"1487","Glynn",2014,82175,81508,667,0.818324581636159
"1488","Glynn",2015,83579,82175,1404,1.7085488287192
"1489","Glynn",2016,84502,83579,923,1.10434439273023
"1490","Glynn",2017,85282,84502,780,0.923055075619512
"1491","Glynn",2018,85219,85282,-63,-0.0738725639642598
"1492","Glynn",2019,85292,85219,73,0.0856616482239876
"1493","Glynn",2020,85568,85292,276,0.323594240960465
"1494","Glynn",2021,84739,85568,-829,-0.968820119670905
"1495","Glynn",2022,85079,84739,340,0.401232018315062
"1496","Gordon",2000,44401,43354,1047,2.41500207593302
"1497","Gordon",2001,45757,44401,1356,3.05398527060201
"1498","Gordon",2002,46939,45757,1182,2.58321131193042
"1499","Gordon",2003,48145,46939,1206,2.56929205990754
"1500","Gordon",2004,49426,48145,1281,2.66071243119742
"1501","Gordon",2005,50602,49426,1176,2.37931453081374
"1502","Gordon",2006,52161,50602,1559,3.08090589304771
"1503","Gordon",2007,53409,52161,1248,2.39259216656122
"1504","Gordon",2008,54567,53409,1158,2.16817390327473
"1505","Gordon",2009,54945,54567,378,0.692726373082632
"1506","Gordon",2010,55214,54945,269,0.48958048958049
"1507","Gordon",2011,55621,55214,407,0.737131886840294
"1508","Gordon",2012,55766,55621,145,0.260692903759371
"1509","Gordon",2013,55757,55766,-9,-0.0161388659756841
"1510","Gordon",2014,56047,55757,290,0.520114066395251
"1511","Gordon",2015,56574,56047,527,0.940282263100612
"1512","Gordon",2016,56904,56574,330,0.583306819386998
"1513","Gordon",2017,57089,56904,185,0.325108955433713
"1514","Gordon",2018,57685,57089,596,1.04398395487747
"1515","Gordon",2019,57963,57685,278,0.481927710843374
"1516","Gordon",2020,58780,57963,817,1.40951986612149
"1517","Gordon",2021,58237,58780,-543,-0.923783599863899
"1518","Gordon",2022,58954,58237,717,1.23117605645895
"1519","Grady",2000,23624,23568,56,0.237610319076714
"1520","Grady",2001,23635,23624,11,0.0465628174737555
"1521","Grady",2002,23635,23635,0,0
"1522","Grady",2003,23716,23635,81,0.342712079543051
"1523","Grady",2004,23840,23716,124,0.522853769607016
"1524","Grady",2005,24031,23840,191,0.801174496644295
"1525","Grady",2006,24384,24031,353,1.46893595772128
"1526","Grady",2007,24624,24384,240,0.984251968503937
"1527","Grady",2008,24728,24624,104,0.422352176738142
"1528","Grady",2009,24893,24728,165,0.667259786476868
"1529","Grady",2010,25060,24893,167,0.670871329289358
"1530","Grady",2011,25255,25060,195,0.778132482043097
"1531","Grady",2012,25440,25255,185,0.732528212235201
"1532","Grady",2013,25278,25440,-162,-0.636792452830189
"1533","Grady",2014,25359,25278,81,0.320436743413245
"1534","Grady",2015,25205,25359,-154,-0.607279466855949
"1535","Grady",2016,24808,25205,-397,-1.57508430866892
"1536","Grady",2017,24819,24808,11,0.0443405353111899
"1537","Grady",2018,24748,24819,-71,-0.286071155163383
"1538","Grady",2019,24633,24748,-115,-0.464684014869888
"1539","Grady",2020,24491,24633,-142,-0.576462469045589
"1540","Grady",2021,25918,24491,1427,5.82663019068229
"1541","Grady",2022,26008,25918,90,0.347249016127788
"1542","Greene",2000,14389,14199,190,1.33812240298613
"1543","Greene",2001,14703,14389,314,2.18222253110015
"1544","Greene",2002,14984,14703,281,1.91117459021968
"1545","Greene",2003,15110,14984,126,0.840896956753871
"1546","Greene",2004,15330,15110,220,1.4559894109861
"1547","Greene",2005,15499,15330,169,1.10241356816699
"1548","Greene",2006,15587,15499,88,0.56777856635912
"1549","Greene",2007,15823,15587,236,1.5140822480272
"1550","Greene",2008,15869,15823,46,0.290716046261771
"1551","Greene",2009,15934,15869,65,0.409603629718319
"1552","Greene",2010,16006,15934,72,0.451863938747333
"1553","Greene",2011,16031,16006,25,0.15619142821442
"1554","Greene",2012,16092,16031,61,0.380512756534215
"1555","Greene",2013,16321,16092,229,1.42306736266468
"1556","Greene",2014,16490,16321,169,1.03547576741621
"1557","Greene",2015,16710,16490,220,1.33414190418435
"1558","Greene",2016,17003,16710,293,1.75344105326152
"1559","Greene",2017,17281,17003,278,1.63500558724931
"1560","Greene",2018,17698,17281,417,2.41305480006944
"1561","Greene",2019,18324,17698,626,3.53712283873884
"1562","Greene",2020,18837,18324,513,2.79960707269155
"1563","Greene",2021,19536,18837,699,3.71078197165154
"1564","Greene",2022,20139,19536,603,3.08660933660934
"1565","Gwinnett",2000,595584,567569,28015,4.93596373304391
"1566","Gwinnett",2001,620025,595584,24441,4.10370325596389
"1567","Gwinnett",2002,641986,620025,21961,3.54195395346962
"1568","Gwinnett",2003,663391,641986,21405,3.33418485761372
"1569","Gwinnett",2004,687468,663391,24077,3.62938297323901
"1570","Gwinnett",2005,710978,687468,23510,3.41979553957421
"1571","Gwinnett",2006,740267,710978,29289,4.11953675078554
"1572","Gwinnett",2007,764129,740267,23862,3.22343154564502
"1573","Gwinnett",2008,780721,764129,16592,2.1713611183452
"1574","Gwinnett",2009,796276,780721,15555,1.99238908649825
"1575","Gwinnett",2010,808719,796276,12443,1.5626491317081
"1576","Gwinnett",2011,824941,808719,16222,2.00588832462203
"1577","Gwinnett",2012,842046,824941,17105,2.07348161868546
"1578","Gwinnett",2013,859304,842046,17258,2.04953173579591
"1579","Gwinnett",2014,877922,859304,18618,2.1666371854431
"1580","Gwinnett",2015,895823,877922,17901,2.03901941174729
"1581","Gwinnett",2016,907135,895823,11312,1.262749449389
"1582","Gwinnett",2017,920260,907135,13125,1.44686292558439
"1583","Gwinnett",2018,927781,920260,7521,0.817269032664682
"1584","Gwinnett",2019,936250,927781,8469,0.912823177021301
"1585","Gwinnett",2020,942627,936250,6377,0.681121495327103
"1586","Gwinnett",2021,964546,942627,21919,2.325310011277
"1587","Gwinnett",2022,975353,964546,10807,1.12042349457672
"1588","Habersham",2000,36095,35196,899,2.55426753040118
"1589","Habersham",2001,36914,36095,819,2.26901232857737
"1590","Habersham",2002,37421,36914,507,1.37346264289971
"1591","Habersham",2003,38051,37421,630,1.68354667165495
"1592","Habersham",2004,38491,38051,440,1.15634280308008
"1593","Habersham",2005,39155,38491,664,1.72507858980021
"1594","Habersham",2006,40616,39155,1461,3.73132422423701
"1595","Habersham",2007,41865,40616,1249,3.07514280086665
"1596","Habersham",2008,42550,41865,685,1.63621163262869
"1597","Habersham",2009,42947,42550,397,0.933019976498237
"1598","Habersham",2010,43080,42947,133,0.309684029152211
"1599","Habersham",2011,43279,43080,199,0.461931290622098
"1600","Habersham",2012,43520,43279,241,0.55685205295871
"1601","Habersham",2013,43300,43520,-220,-0.505514705882353
"1602","Habersham",2014,43752,43300,452,1.04387990762125
"1603","Habersham",2015,43996,43752,244,0.557688791369537
"1604","Habersham",2016,44246,43996,250,0.568233475770525
"1605","Habersham",2017,44567,44246,321,0.725489309768115
"1606","Habersham",2018,45388,44567,821,1.8421702156304
"1607","Habersham",2019,45328,45388,-60,-0.132193531329867
"1608","Habersham",2020,46047,45328,719,1.58621602541475
"1609","Habersham",2021,46774,46047,727,1.5788216387604
"1610","Habersham",2022,47475,46774,701,1.49869585667251
"1611","Hall",2000,140993,134781,6212,4.60895823595314
"1612","Hall",2001,146148,140993,5155,3.65620988276014
"1613","Hall",2002,150229,146148,4081,2.79237485288885
"1614","Hall",2003,153561,150229,3332,2.21794726717212
"1615","Hall",2004,156385,153561,2824,1.83900860244463
"1616","Hall",2005,160979,156385,4594,2.93762189468299
"1617","Hall",2006,166524,160979,5545,3.44454866783866
"1618","Hall",2007,172446,166524,5922,3.55624414498811
"1619","Hall",2008,177277,172446,4831,2.8014566878907
"1620","Hall",2009,178503,177277,1226,0.691573074905374
"1621","Hall",2010,180253,178503,1750,0.980375679960561
"1622","Hall",2011,183052,180253,2799,1.55281742883614
"1623","Hall",2012,185416,183052,2364,1.29143631317877
"1624","Hall",2013,187745,185416,2329,1.25609440393494
"1625","Hall",2014,190761,187745,3016,1.6064342592346
"1626","Hall",2015,193535,190761,2774,1.45417564386851
"1627","Hall",2016,196637,193535,3102,1.60281086108456
"1628","Hall",2017,199335,196637,2698,1.37207138025906
"1629","Hall",2018,202148,199335,2813,1.41119221411192
"1630","Hall",2019,204441,202148,2293,1.13431743079328
"1631","Hall",2020,206591,204441,2150,1.05164815276779
"1632","Hall",2021,207369,206591,778,0.376589493249948
"1633","Hall",2022,212692,207369,5323,2.5669217674773
"1634","Hancock",2000,10066,10021,45,0.449056980341283
"1635","Hancock",2001,10022,10066,-44,-0.437115040731174
"1636","Hancock",2002,9829,10022,-193,-1.92576332069447
"1637","Hancock",2003,9764,9829,-65,-0.661308373181402
"1638","Hancock",2004,9673,9764,-91,-0.931995083981975
"1639","Hancock",2005,9634,9673,-39,-0.403184120748475
"1640","Hancock",2006,9650,9634,16,0.166078472078057
"1641","Hancock",2007,9889,9650,239,2.47668393782383
"1642","Hancock",2008,9808,9889,-81,-0.819091920315502
"1643","Hancock",2009,9508,9808,-300,-3.05872756933116
"1644","Hancock",2010,9391,9508,-117,-1.23054270088347
"1645","Hancock",2011,9400,9391,9,0.0958364391438611
"1646","Hancock",2012,8996,9400,-404,-4.29787234042553
"1647","Hancock",2013,8879,8996,-117,-1.30057803468208
"1648","Hancock",2014,8509,8879,-370,-4.16713593873184
"1649","Hancock",2015,8551,8509,42,0.49359501704078
"1650","Hancock",2016,8640,8551,89,1.04081393989007
"1651","Hancock",2017,8561,8640,-79,-0.914351851851852
"1652","Hancock",2018,8348,8561,-213,-2.48802709963789
"1653","Hancock",2019,8457,8348,109,1.30570196454241
"1654","Hancock",2020,8494,8457,37,0.437507390327539
"1655","Hancock",2021,8630,8494,136,1.60113020955969
"1656","Hancock",2022,8387,8630,-243,-2.81575898030127
"1657","Haralson",2000,25788,25301,487,1.92482510572705
"1658","Haralson",2001,26232,25788,444,1.72173103769195
"1659","Haralson",2002,26676,26232,444,1.69258920402562
"1660","Haralson",2003,27227,26676,551,2.06552706552707
"1661","Haralson",2004,27621,27227,394,1.44709295919492
"1662","Haralson",2005,27987,27621,366,1.32507874443358
"1663","Haralson",2006,28121,27987,134,0.478793725658341
"1664","Haralson",2007,28558,28121,437,1.55399879093916
"1665","Haralson",2008,28645,28558,87,0.304643182295679
"1666","Haralson",2009,28774,28645,129,0.450340373538139
"1667","Haralson",2010,28774,28774,0,0
"1668","Haralson",2011,28638,28774,-136,-0.472648919163133
"1669","Haralson",2012,28400,28638,-238,-0.831063621761296
"1670","Haralson",2013,28495,28400,95,0.334507042253521
"1671","Haralson",2014,28641,28495,146,0.512370591331813
"1672","Haralson",2015,28854,28641,213,0.743689117000105
"1673","Haralson",2016,29042,28854,188,0.651556110071394
"1674","Haralson",2017,29256,29042,214,0.736863852351766
"1675","Haralson",2018,29533,29256,277,0.946814328684714
"1676","Haralson",2019,29792,29533,259,0.876985067551552
"1677","Haralson",2020,30383,29792,591,1.98375402792696
"1678","Haralson",2021,30572,30383,189,0.622058387914294
"1679","Haralson",2022,31337,30572,765,2.50228967682847
"1680","Harris",2000,23912,23382,530,2.26670088101959
"1681","Harris",2001,24547,23912,635,2.65557042489127
"1682","Harris",2002,25327,24547,780,3.17757770807023
"1683","Harris",2003,26256,25327,929,3.66802226872508
"1684","Harris",2004,27180,26256,924,3.51919561243144
"1685","Harris",2005,28170,27180,990,3.64238410596026
"1686","Harris",2006,29289,28170,1119,3.97231096911608
"1687","Harris",2007,30276,29289,987,3.3698658199324
"1688","Harris",2008,30807,30276,531,1.7538644470868
"1689","Harris",2009,31494,30807,687,2.23001265946051
"1690","Harris",2010,32167,31494,673,2.1369149679304
"1691","Harris",2011,32265,32167,98,0.304660055336214
"1692","Harris",2012,32550,32265,285,0.883310088331009
"1693","Harris",2013,32663,32550,113,0.34715821812596
"1694","Harris",2014,32876,32663,213,0.652114012797355
"1695","Harris",2015,33381,32876,505,1.53607494829055
"1696","Harris",2016,33652,33381,271,0.811839070129714
"1697","Harris",2017,33915,33652,263,0.781528586711043
"1698","Harris",2018,34475,33915,560,1.65118679050568
"1699","Harris",2019,35236,34475,761,2.20739666424946
"1700","Harris",2020,36080,35236,844,2.39527755704393
"1701","Harris",2021,35626,36080,-454,-1.25831485587583
"1702","Harris",2022,36276,35626,650,1.82451018918767
"1703","Hart",2000,23046,22754,292,1.28329084996045
"1704","Hart",2001,23049,23046,3,0.0130174433741213
"1705","Hart",2002,23286,23049,237,1.0282441754523
"1706","Hart",2003,23402,23286,116,0.498153396890836
"1707","Hart",2004,23966,23402,564,2.41005042304077
"1708","Hart",2005,24376,23966,410,1.71075690561629
"1709","Hart",2006,24764,24376,388,1.59172957006892
"1710","Hart",2007,24894,24764,130,0.524955580681635
"1711","Hart",2008,25138,24894,244,0.980155860850004
"1712","Hart",2009,25108,25138,-30,-0.119341236375209
"1713","Hart",2010,25217,25108,109,0.434124581806595
"1714","Hart",2011,25305,25217,88,0.34897093230757
"1715","Hart",2012,25518,25305,213,0.841730883224659
"1716","Hart",2013,25446,25518,-72,-0.282153773806725
"1717","Hart",2014,25377,25446,-69,-0.271162461683565
"1718","Hart",2015,25534,25377,157,0.618670449619734
"1719","Hart",2016,25553,25534,19,0.0744105898018328
"1720","Hart",2017,25794,25553,241,0.943137792040074
"1721","Hart",2018,26099,25794,305,1.18244552996821
"1722","Hart",2019,26205,26099,106,0.40614582934212
"1723","Hart",2020,26406,26205,201,0.767029192902118
"1724","Hart",2021,26409,26406,3,0.0113610543058396
"1725","Hart",2022,26909,26409,500,1.89329395281911
"1726","Heard",2000,11038,10737,301,2.80339014622334
"1727","Heard",2001,11173,11038,135,1.22304765356043
"1728","Heard",2002,11207,11173,34,0.304305021032847
"1729","Heard",2003,11169,11207,-38,-0.339073793164986
"1730","Heard",2004,11273,11169,104,0.93114871519384
"1731","Heard",2005,11350,11273,77,0.683047990774417
"1732","Heard",2006,11553,11350,203,1.78854625550661
"1733","Heard",2007,11618,11553,65,0.562624426555873
"1734","Heard",2008,11809,11618,191,1.64400068858668
"1735","Heard",2009,11765,11809,-44,-0.372597171648742
"1736","Heard",2010,11854,11765,89,0.756481087972801
"1737","Heard",2011,11744,11854,-110,-0.927956807828581
"1738","Heard",2012,11633,11744,-111,-0.94516348773842
"1739","Heard",2013,11558,11633,-75,-0.644717613685206
"1740","Heard",2014,11603,11558,45,0.389340716386918
"1741","Heard",2015,11539,11603,-64,-0.551581487546324
"1742","Heard",2016,11487,11539,-52,-0.450645636536962
"1743","Heard",2017,11730,11487,243,2.11543483938365
"1744","Heard",2018,11879,11730,149,1.27024722932651
"1745","Heard",2019,11923,11879,44,0.370401548951932
"1746","Heard",2020,11973,11923,50,0.419357544242221
"1747","Heard",2021,11565,11973,-408,-3.40766725131546
"1748","Heard",2022,11725,11565,160,1.38348465196714
"1749","Henry",2000,121774,113011,8763,7.75411243153321
"1750","Henry",2001,131000,121774,9226,7.57632992264359
"1751","Henry",2002,140747,131000,9747,7.44045801526718
"1752","Henry",2003,150928,140747,10181,7.23354671858015
"1753","Henry",2004,159971,150928,9043,5.99159864306159
"1754","Henry",2005,169607,159971,9636,6.0235917760094
"1755","Henry",2006,180304,169607,10697,6.30693308648818
"1756","Henry",2007,188736,180304,8432,4.67654627739817
"1757","Henry",2008,194658,188736,5922,3.13771617497457
"1758","Henry",2009,199622,194658,4964,2.55011353245179
"1759","Henry",2010,205265,199622,5643,2.82684273276493
"1760","Henry",2011,207360,205265,2095,1.02063186612428
"1761","Henry",2012,209053,207360,1693,0.816454475308642
"1762","Henry",2013,211128,209053,2075,0.992571261833124
"1763","Henry",2014,213869,211128,2741,1.29826455988784
"1764","Henry",2015,217739,213869,3870,1.80951891110914
"1765","Henry",2016,221768,217739,4029,1.85038050142602
"1766","Henry",2017,225813,221768,4045,1.82397821146423
"1767","Henry",2018,230220,225813,4407,1.95161483174131
"1768","Henry",2019,234561,230220,4341,1.88558769872296
"1769","Henry",2020,239139,234561,4578,1.95173110619412
"1770","Henry",2021,245235,239139,6096,2.5491450578952
"1771","Henry",2022,248364,245235,3129,1.27591901645361
"1772","Houston",2000,111294,109216,2078,1.90265162613536
"1773","Houston",2001,113432,111294,2138,1.92103797149891
"1774","Houston",2002,116411,113432,2979,2.626243035475
"1775","Houston",2003,119396,116411,2985,2.56419066926665
"1776","Houston",2004,123723,119396,4327,3.62407450835874
"1777","Houston",2005,126201,123723,2478,2.00286123032904
"1778","Houston",2006,128978,126201,2777,2.20045799954042
"1779","Houston",2007,132373,128978,3395,2.63223185349439
"1780","Houston",2008,134922,132373,2549,1.92561927281243
"1781","Houston",2009,137416,134922,2494,1.84847541542521
"1782","Houston",2010,140713,137416,3297,2.39928392618036
"1783","Houston",2011,143925,140713,3212,2.28266045070463
"1784","Houston",2012,146136,143925,2211,1.53621677957269
"1785","Houston",2013,147658,146136,1522,1.04149559314611
"1786","Houston",2014,149111,147658,1453,0.984030665456663
"1787","Houston",2015,150033,149111,922,0.618331310231975
"1788","Houston",2016,152122,150033,2089,1.39236034739024
"1789","Houston",2017,153479,152122,1357,0.892047172664046
"1790","Houston",2018,155469,153479,1990,1.29659432235029
"1791","Houston",2019,157863,155469,2394,1.53985682033074
"1792","Houston",2020,160110,157863,2247,1.42338610060622
"1793","Houston",2021,166829,160110,6719,4.19648991318468
"1794","Houston",2022,169631,166829,2802,1.67956410456216
"1795","Irwin",2000,9905,9793,112,1.14367405289492
"1796","Irwin",2001,9953,9905,48,0.484603735487128
"1797","Irwin",2002,9775,9953,-178,-1.78840550587762
"1798","Irwin",2003,9777,9775,2,0.020460358056266
"1799","Irwin",2004,9402,9777,-375,-3.83553237189322
"1800","Irwin",2005,9779,9402,377,4.0097851520953
"1801","Irwin",2006,9852,9779,73,0.746497596891298
"1802","Irwin",2007,9493,9852,-359,-3.64393016646366
"1803","Irwin",2008,9803,9493,310,3.26556409986306
"1804","Irwin",2009,9536,9803,-267,-2.72365602366622
"1805","Irwin",2010,9528,9536,-8,-0.0838926174496644
"1806","Irwin",2011,9679,9528,151,1.5848026868178
"1807","Irwin",2012,9600,9679,-79,-0.816200020663292
"1808","Irwin",2013,9427,9600,-173,-1.80208333333333
"1809","Irwin",2014,9104,9427,-323,-3.42632863052933
"1810","Irwin",2015,9245,9104,141,1.548769771529
"1811","Irwin",2016,9422,9245,177,1.914548404543
"1812","Irwin",2017,9410,9422,-12,-0.127361494374867
"1813","Irwin",2018,9398,9410,-12,-0.127523910733262
"1814","Irwin",2019,9416,9398,18,0.191530112789955
"1815","Irwin",2020,9387,9416,-29,-0.307986406117247
"1816","Irwin",2021,9618,9387,231,2.46085011185682
"1817","Irwin",2022,9126,9618,-492,-5.11540860885839
"1818","Jackson",2000,41845,40445,1400,3.46149091358635
"1819","Jackson",2001,43367,41845,1522,3.63723264428247
"1820","Jackson",2002,44940,43367,1573,3.62718195863214
"1821","Jackson",2003,46230,44940,1290,2.87049399198932
"1822","Jackson",2004,48288,46230,2058,4.45165476963011
"1823","Jackson",2005,50607,48288,2319,4.80243538767396
"1824","Jackson",2006,54037,50607,3430,6.77771849744107
"1825","Jackson",2007,57521,54037,3484,6.44743416547921
"1826","Jackson",2008,59420,57521,1899,3.30140296587333
"1827","Jackson",2009,60052,59420,632,1.06361494446314
"1828","Jackson",2010,60706,60052,654,1.08905615133551
"1829","Jackson",2011,61257,60706,551,0.907653279741706
"1830","Jackson",2012,60571,61257,-686,-1.1198720146269
"1831","Jackson",2013,61044,60571,473,0.780901751663337
"1832","Jackson",2014,61870,61044,826,1.35312233798572
"1833","Jackson",2015,63360,61870,1490,2.40827541619525
"1834","Jackson",2016,64615,63360,1255,1.98074494949495
"1835","Jackson",2017,67519,64615,2904,4.49431246614563
"1836","Jackson",2018,70422,67519,2903,4.29953050252522
"1837","Jackson",2019,72977,70422,2555,3.62812757376956
"1838","Jackson",2020,76199,72977,3222,4.41508968579141
"1839","Jackson",2021,80286,76199,4087,5.36358744865418
"1840","Jackson",2022,83936,80286,3650,4.54624716638019
"1841","Jasper",2000,11496,11177,319,2.85407533327369
"1842","Jasper",2001,11629,11496,133,1.15692414752958
"1843","Jasper",2002,12027,11629,398,3.42247828704102
"1844","Jasper",2003,12417,12027,390,3.24270391618858
"1845","Jasper",2004,12588,12417,171,1.37714423773858
"1846","Jasper",2005,12985,12588,397,3.15379726723864
"1847","Jasper",2006,13370,12985,385,2.96495956873315
"1848","Jasper",2007,13569,13370,199,1.48840688107704
"1849","Jasper",2008,13769,13569,200,1.47394796963667
"1850","Jasper",2009,13842,13769,73,0.53017648340475
"1851","Jasper",2010,13926,13842,84,0.606848721283052
"1852","Jasper",2011,13885,13926,-41,-0.294413327588683
"1853","Jasper",2012,13630,13885,-255,-1.83651422398272
"1854","Jasper",2013,13601,13630,-29,-0.212765957446809
"1855","Jasper",2014,13432,13601,-169,-1.24255569443423
"1856","Jasper",2015,13635,13432,203,1.51131625967838
"1857","Jasper",2016,13654,13635,19,0.139347268060139
"1858","Jasper",2017,13964,13654,310,2.27039695327377
"1859","Jasper",2018,14040,13964,76,0.544256659982813
"1860","Jasper",2019,14219,14040,179,1.27492877492877
"1861","Jasper",2020,14483,14219,264,1.85667065194458
"1862","Jasper",2021,15278,14483,795,5.48919422771525
"1863","Jasper",2022,15951,15278,673,4.40502683597329
"1864","Jeff Davis",2000,12734,12609,125,0.991355381077008
"1865","Jeff Davis",2001,12877,12734,143,1.12297785456259
"1866","Jeff Davis",2002,13088,12877,211,1.63858041469286
"1867","Jeff Davis",2003,13234,13088,146,1.11552567237164
"1868","Jeff Davis",2004,13433,13234,199,1.50370258425268
"1869","Jeff Davis",2005,13729,13433,296,2.20352862353905
"1870","Jeff Davis",2006,14028,13729,299,2.17787165853303
"1871","Jeff Davis",2007,14204,14028,176,1.25463358996293
"1872","Jeff Davis",2008,14577,14204,373,2.62602083920023
"1873","Jeff Davis",2009,14892,14577,315,2.16093846470467
"1874","Jeff Davis",2010,15091,14892,199,1.33628793983347
"1875","Jeff Davis",2011,15162,15091,71,0.470479093499437
"1876","Jeff Davis",2012,15156,15162,-6,-0.0395726157499011
"1877","Jeff Davis",2013,15004,15156,-152,-1.00290314067036
"1878","Jeff Davis",2014,14859,15004,-145,-0.966408957611304
"1879","Jeff Davis",2015,14920,14859,61,0.410525607376001
"1880","Jeff Davis",2016,14877,14920,-43,-0.288203753351206
"1881","Jeff Davis",2017,15025,14877,148,0.994824225314244
"1882","Jeff Davis",2018,15029,15025,4,0.0266222961730449
"1883","Jeff Davis",2019,15115,15029,86,0.572227027746357
"1884","Jeff Davis",2020,15213,15115,98,0.648362553754548
"1885","Jeff Davis",2021,14872,15213,-341,-2.24150397686189
"1886","Jeff Davis",2022,14889,14872,17,0.114308768154922
"1887","Jefferson",2000,17229,17342,-113,-0.651597278283935
"1888","Jefferson",2001,17121,17229,-108,-0.62685007835626
"1889","Jefferson",2002,17091,17121,-30,-0.175223409847556
"1890","Jefferson",2003,17019,17091,-72,-0.421274354923644
"1891","Jefferson",2004,16988,17019,-31,-0.182149362477231
"1892","Jefferson",2005,16924,16988,-64,-0.376736519896397
"1893","Jefferson",2006,16889,16924,-35,-0.20680690144174
"1894","Jefferson",2007,16830,16889,-59,-0.349339806974954
"1895","Jefferson",2008,16925,16830,95,0.564468211527035
"1896","Jefferson",2009,17067,16925,142,0.838995568685377
"1897","Jefferson",2010,16884,17067,-183,-1.07224468272104
"1898","Jefferson",2011,16675,16884,-209,-1.23785832741057
"1899","Jefferson",2012,16432,16675,-243,-1.45727136431784
"1900","Jefferson",2013,16320,16432,-112,-0.68159688412853
"1901","Jefferson",2014,16272,16320,-48,-0.294117647058824
"1902","Jefferson",2015,16106,16272,-166,-1.02015732546706
"1903","Jefferson",2016,15916,16106,-190,-1.17968458959394
"1904","Jefferson",2017,15648,15916,-268,-1.68384016084443
"1905","Jefferson",2018,15430,15648,-218,-1.39314928425358
"1906","Jefferson",2019,15362,15430,-68,-0.440699935191186
"1907","Jefferson",2020,15267,15362,-95,-0.618409061320141
"1908","Jefferson",2021,15524,15267,257,1.68336935874763
"1909","Jefferson",2022,15314,15524,-210,-1.35274413810873
"1910","Jenkins",2000,8584,8510,74,0.869565217391304
"1911","Jenkins",2001,8577,8584,-7,-0.081547064305685
"1912","Jenkins",2002,8543,8577,-34,-0.396409000816136
"1913","Jenkins",2003,8518,8543,-25,-0.292637246868781
"1914","Jenkins",2004,8490,8518,-28,-0.328715660953275
"1915","Jenkins",2005,8510,8490,20,0.235571260306243
"1916","Jenkins",2006,8533,8510,23,0.27027027027027
"1917","Jenkins",2007,8442,8533,-91,-1.06644790812141
"1918","Jenkins",2008,8340,8442,-102,-1.20824449182658
"1919","Jenkins",2009,8339,8340,-1,-0.0119904076738609
"1920","Jenkins",2010,8345,8339,6,0.0719510732701763
"1921","Jenkins",2011,8148,8345,-197,-2.36069502696225
"1922","Jenkins",2012,9213,8148,1065,13.0706921944035
"1923","Jenkins",2013,9269,9213,56,0.607836752415066
"1924","Jenkins",2014,9125,9269,-144,-1.55356564893732
"1925","Jenkins",2015,8957,9125,-168,-1.84109589041096
"1926","Jenkins",2016,8849,8957,-108,-1.20576085742994
"1927","Jenkins",2017,8767,8849,-82,-0.926658379477907
"1928","Jenkins",2018,8683,8767,-84,-0.958138473822288
"1929","Jenkins",2019,8676,8683,-7,-0.0806172981688357
"1930","Jenkins",2020,8746,8676,70,0.806823420931305
"1931","Jenkins",2021,8639,8746,-107,-1.22341641893437
"1932","Jenkins",2022,8689,8639,50,0.578770691052205
"1933","Johnson",2000,8567,8551,16,0.187112618407204
"1934","Johnson",2001,8768,8567,201,2.34621220964165
"1935","Johnson",2002,9436,8768,668,7.61861313868613
"1936","Johnson",2003,9456,9436,20,0.211954217888936
"1937","Johnson",2004,9613,9456,157,1.66032148900169
"1938","Johnson",2005,9516,9613,-97,-1.00905024446063
"1939","Johnson",2006,9638,9516,122,1.28205128205128
"1940","Johnson",2007,10107,9638,469,4.86615480390122
"1941","Johnson",2008,10127,10107,20,0.197882655585238
"1942","Johnson",2009,9990,10127,-137,-1.35281919620816
"1943","Johnson",2010,9971,9990,-19,-0.19019019019019
"1944","Johnson",2011,9975,9971,4,0.0401163373783974
"1945","Johnson",2012,9897,9975,-78,-0.781954887218045
"1946","Johnson",2013,9767,9897,-130,-1.31352935232899
"1947","Johnson",2014,9701,9767,-66,-0.675744855124398
"1948","Johnson",2015,9656,9701,-45,-0.463869704154211
"1949","Johnson",2016,9505,9656,-151,-1.56379453189727
"1950","Johnson",2017,9788,9505,283,2.97738032614413
"1951","Johnson",2018,9708,9788,-80,-0.81732733959951
"1952","Johnson",2019,9643,9708,-65,-0.669550885867326
"1953","Johnson",2020,9667,9643,24,0.248885201700716
"1954","Johnson",2021,9160,9667,-507,-5.24464673631944
"1955","Johnson",2022,9242,9160,82,0.895196506550218
"1956","Jones",2000,23762,23437,325,1.38669624951999
"1957","Jones",2001,24315,23762,553,2.32724518138204
"1958","Jones",2002,24909,24315,594,2.44293645897594
"1959","Jones",2003,25738,24909,829,3.32811433618371
"1960","Jones",2004,26537,25738,799,3.10435931307794
"1961","Jones",2005,27189,26537,652,2.45694690432227
"1962","Jones",2006,27563,27189,374,1.37555629114716
"1963","Jones",2007,28000,27563,437,1.5854587671879
"1964","Jones",2008,28552,28000,552,1.97142857142857
"1965","Jones",2009,28710,28552,158,0.553376295881199
"1966","Jones",2010,28634,28710,-76,-0.264716126785092
"1967","Jones",2011,28516,28634,-118,-0.412097506460851
"1968","Jones",2012,28577,28516,61,0.213914995090476
"1969","Jones",2013,28569,28577,-8,-0.0279945410644924
"1970","Jones",2014,28787,28569,218,0.763064860513144
"1971","Jones",2015,28494,28787,-293,-1.01782054399555
"1972","Jones",2016,28623,28494,129,0.452726889871552
"1973","Jones",2017,28470,28623,-153,-0.534535164028928
"1974","Jones",2018,28616,28470,146,0.512820512820513
"1975","Jones",2019,28735,28616,119,0.415851272015656
"1976","Jones",2020,28787,28735,52,0.180963981207587
"1977","Jones",2021,28400,28787,-387,-1.34435682773474
"1978","Jones",2022,28472,28400,72,0.253521126760563
"1979","Lamar",2000,16024,15593,431,2.76406079651125
"1980","Lamar",2001,16464,16024,440,2.74588117823265
"1981","Lamar",2002,16289,16464,-175,-1.06292517006803
"1982","Lamar",2003,16470,16289,181,1.11117932346983
"1983","Lamar",2004,16567,16470,97,0.588949605343048
"1984","Lamar",2005,16961,16567,394,2.37822176616165
"1985","Lamar",2006,17115,16961,154,0.907965332232769
"1986","Lamar",2007,17476,17115,361,2.10926088226702
"1987","Lamar",2008,18025,17476,549,3.14145113298238
"1988","Lamar",2009,18233,18025,208,1.15395284327323
"1989","Lamar",2010,18335,18233,102,0.559425218011298
"1990","Lamar",2011,18194,18335,-141,-0.769020998091083
"1991","Lamar",2012,18057,18194,-137,-0.752995493019677
"1992","Lamar",2013,17959,18057,-98,-0.542725812704214
"1993","Lamar",2014,18207,17959,248,1.38092321398742
"1994","Lamar",2015,18201,18207,-6,-0.0329543582138738
"1995","Lamar",2016,18469,18201,268,1.47244656886984
"1996","Lamar",2017,18599,18469,130,0.703882180951865
"1997","Lamar",2018,19000,18599,401,2.15602989408033
"1998","Lamar",2019,19077,19000,77,0.405263157894737
"1999","Lamar",2020,19261,19077,184,0.964512239870001
"2000","Lamar",2021,19080,19261,-181,-0.939722755827839
"2001","Lamar",2022,19467,19080,387,2.02830188679245
"2002","Lanier",2000,7283,7170,113,1.57601115760112
"2003","Lanier",2001,7253,7283,-30,-0.411918165591103
"2004","Lanier",2002,7422,7253,169,2.33007031573142
"2005","Lanier",2003,7748,7422,326,4.39234707625977
"2006","Lanier",2004,7824,7748,76,0.980898296334538
"2007","Lanier",2005,8068,7824,244,3.11860940695297
"2008","Lanier",2006,8509,8068,441,5.466038671294
"2009","Lanier",2007,9013,8509,504,5.92314020448936
"2010","Lanier",2008,9560,9013,547,6.06901142793742
"2011","Lanier",2009,9810,9560,250,2.61506276150628
"2012","Lanier",2010,10126,9810,316,3.22120285423038
"2013","Lanier",2011,10404,10126,278,2.745407860952
"2014","Lanier",2012,10400,10404,-4,-0.0384467512495194
"2015","Lanier",2013,10408,10400,8,0.0769230769230769
"2016","Lanier",2014,10373,10408,-35,-0.336279784780938
"2017","Lanier",2015,10312,10373,-61,-0.588065169189241
"2018","Lanier",2016,10399,10312,87,0.843677269200931
"2019","Lanier",2017,10425,10399,26,0.250024040773151
"2020","Lanier",2018,10340,10425,-85,-0.815347721822542
"2021","Lanier",2019,10423,10340,83,0.802707930367505
"2022","Lanier",2020,10737,10423,314,3.01256835843807
"2023","Lanier",2021,9907,10737,-830,-7.73027847629692
"2024","Lanier",2022,10171,9907,264,2.66478247703644
"2025","Laurens",2000,44931,44573,358,0.803176811073968
"2026","Laurens",2001,45123,44931,192,0.427321893570141
"2027","Laurens",2002,45634,45123,511,1.13246016443942
"2028","Laurens",2003,46277,45634,643,1.40903712144454
"2029","Laurens",2004,46329,46277,52,0.112366834496618
"2030","Laurens",2005,46751,46329,422,0.910876556800276
"2031","Laurens",2006,47287,46751,536,1.14649954011679
"2032","Laurens",2007,47649,47287,362,0.765538097151437
"2033","Laurens",2008,48192,47649,543,1.13958320216584
"2034","Laurens",2009,48601,48192,409,0.848688579017264
"2035","Laurens",2010,48439,48601,-162,-0.333326474763894
"2036","Laurens",2011,47949,48439,-490,-1.01158157682859
"2037","Laurens",2012,48041,47949,92,0.19187052910384
"2038","Laurens",2013,47999,48041,-42,-0.0874253242022439
"2039","Laurens",2014,47851,47999,-148,-0.308339757078272
"2040","Laurens",2015,47731,47851,-120,-0.250778458130447
"2041","Laurens",2016,47516,47731,-215,-0.450441013178019
"2042","Laurens",2017,47330,47516,-186,-0.391447091506019
"2043","Laurens",2018,47325,47330,-5,-0.010564124234101
"2044","Laurens",2019,47546,47325,221,0.466983623877443
"2045","Laurens",2020,47512,47546,-34,-0.0715096958734699
"2046","Laurens",2021,49547,47512,2035,4.28312847280687
"2047","Laurens",2022,49660,49547,113,0.228066280501342
"2048","Lee",2000,24808,24335,473,1.94370248613109
"2049","Lee",2001,24945,24808,137,0.552241212512093
"2050","Lee",2002,25115,24945,170,0.681499298456605
"2051","Lee",2003,25260,25115,145,0.577344216603623
"2052","Lee",2004,25965,25260,705,2.79097387173397
"2053","Lee",2005,26505,25965,540,2.07972270363951
"2054","Lee",2006,27365,26505,860,3.24467081682701
"2055","Lee",2007,27792,27365,427,1.56038735611182
"2056","Lee",2008,28111,27792,319,1.14781232009211
"2057","Lee",2009,28326,28111,215,0.764825157411689
"2058","Lee",2010,28397,28326,71,0.250653110216762
"2059","Lee",2011,28575,28397,178,0.626826777476494
"2060","Lee",2012,28746,28575,171,0.598425196850394
"2061","Lee",2013,29071,28746,325,1.13059208237668
"2062","Lee",2014,29191,29071,120,0.412782498022084
"2063","Lee",2015,29202,29191,11,0.0376828474529821
"2064","Lee",2016,29337,29202,135,0.462297102938155
"2065","Lee",2017,29470,29337,133,0.453352421856359
"2066","Lee",2018,29764,29470,294,0.997624703087886
"2067","Lee",2019,29992,29764,228,0.766026071764548
"2068","Lee",2020,30234,29992,242,0.806881835156042
"2069","Lee",2021,33411,30234,3177,10.5080373089899
"2070","Lee",2022,33642,33411,231,0.691389063482087
"2071","Liberty",2000,61811,61987,-176,-0.283930501556778
"2072","Liberty",2001,61388,61811,-423,-0.684344210577405
"2073","Liberty",2002,62505,61388,1117,1.81957385808301
"2074","Liberty",2003,60403,62505,-2102,-3.36293096552276
"2075","Liberty",2004,63254,60403,2851,4.71996424018675
"2076","Liberty",2005,64718,63254,1464,2.31447813577007
"2077","Liberty",2006,63047,64718,-1671,-2.58197101270126
"2078","Liberty",2007,63708,63047,661,1.0484241914762
"2079","Liberty",2008,62635,63708,-1073,-1.68424687637345
"2080","Liberty",2009,67061,62635,4426,7.06633671270057
"2081","Liberty",2010,62819,67061,-4242,-6.3255841696366
"2082","Liberty",2011,65451,62819,2632,4.18981518330441
"2083","Liberty",2012,65471,65451,20,0.0305572107378039
"2084","Liberty",2013,64135,65471,-1336,-2.04059812741519
"2085","Liberty",2014,65198,64135,1063,1.65744133468465
"2086","Liberty",2015,62467,65198,-2731,-4.18877879689561
"2087","Liberty",2016,62570,62467,103,0.164887060367874
"2088","Liberty",2017,61386,62570,-1184,-1.89228064567684
"2089","Liberty",2018,61497,61386,111,0.180822988955136
"2090","Liberty",2019,61435,61497,-62,-0.100817926077695
"2091","Liberty",2020,63004,61435,1569,2.55391877594205
"2092","Liberty",2021,65711,63004,2707,4.29655259983493
"2093","Liberty",2022,68030,65711,2319,3.52908949795316
"2094","Lincoln",2000,8335,8313,22,0.264645735594851
"2095","Lincoln",2001,8375,8335,40,0.479904019196161
"2096","Lincoln",2002,8375,8375,0,0
"2097","Lincoln",2003,8357,8375,-18,-0.214925373134328
"2098","Lincoln",2004,8284,8357,-73,-0.873519205456504
"2099","Lincoln",2005,8274,8284,-10,-0.12071463061323
"2100","Lincoln",2006,8198,8274,-76,-0.918540004834421
"2101","Lincoln",2007,8161,8198,-37,-0.451329592583557
"2102","Lincoln",2008,8156,8161,-5,-0.061267001592942
"2103","Lincoln",2009,8073,8156,-83,-1.01765571358509
"2104","Lincoln",2010,7966,8073,-107,-1.32540567323176
"2105","Lincoln",2011,7862,7966,-104,-1.30554858147125
"2106","Lincoln",2012,7737,7862,-125,-1.58992622742305
"2107","Lincoln",2013,7751,7737,14,0.180948688122011
"2108","Lincoln",2014,7622,7751,-129,-1.66430138046704
"2109","Lincoln",2015,7673,7622,51,0.669115717659407
"2110","Lincoln",2016,7828,7673,155,2.02007037664538
"2111","Lincoln",2017,7880,7828,52,0.664282064384262
"2112","Lincoln",2018,7915,7880,35,0.444162436548223
"2113","Lincoln",2019,7921,7915,6,0.0758054327226785
"2114","Lincoln",2020,8031,7921,110,1.38871354626941
"2115","Lincoln",2021,7749,8031,-282,-3.51139335076578
"2116","Lincoln",2022,7841,7749,92,1.18724996773777
"2117","Long",2000,10370,10108,262,2.59200633161852
"2118","Long",2001,10551,10370,181,1.74541947926712
"2119","Long",2002,10894,10551,343,3.25087669415221
"2120","Long",2003,10849,10894,-45,-0.41307141545805
"2121","Long",2004,11355,10849,506,4.66402433404
"2122","Long",2005,11677,11355,322,2.83575517393219
"2123","Long",2006,12152,11677,475,4.0678256401473
"2124","Long",2007,12381,12152,229,1.88446346280448
"2125","Long",2008,12744,12381,363,2.93191180033923
"2126","Long",2009,13787,12744,1043,8.1842435655995
"2127","Long",2010,14644,13787,857,6.21600058025676
"2128","Long",2011,15136,14644,492,3.35973777656378
"2129","Long",2012,16048,15136,912,6.02536997885835
"2130","Long",2013,16624,16048,576,3.58923230309073
"2131","Long",2014,17113,16624,489,2.94153031761309
"2132","Long",2015,17731,17113,618,3.61128966282943
"2133","Long",2016,18437,17731,706,3.9817269189555
"2134","Long",2017,19014,18437,577,3.12957639529208
"2135","Long",2018,18998,19014,-16,-0.0841485221415799
"2136","Long",2019,19559,18998,561,2.95294241499105
"2137","Long",2020,20171,19559,612,3.12899432486323
"2138","Long",2021,17152,20171,-3019,-14.9670318774478
"2139","Long",2022,18348,17152,1196,6.97294776119403
"2140","Lowndes",2000,92206,91472,734,0.802431345111072
"2141","Lowndes",2001,92402,92206,196,0.212567511875583
"2142","Lowndes",2002,93903,92402,1501,1.62442371377243
"2143","Lowndes",2003,94207,93903,304,0.323738325719093
"2144","Lowndes",2004,96510,94207,2303,2.44461664207543
"2145","Lowndes",2005,98273,96510,1763,1.82675370427935
"2146","Lowndes",2006,100592,98273,2319,2.3597529331556
"2147","Lowndes",2007,101752,100592,1160,1.15317321456975
"2148","Lowndes",2008,104918,101752,3166,3.11148675210315
"2149","Lowndes",2009,107583,104918,2665,2.54007891877466
"2150","Lowndes",2010,109734,107583,2151,1.99938652017512
"2151","Lowndes",2011,111885,109734,2151,1.96019465252337
"2152","Lowndes",2012,114552,111885,2667,2.38369754658801
"2153","Lowndes",2013,112916,114552,-1636,-1.42817235840492
"2154","Lowndes",2014,113523,112916,607,0.537567749477488
"2155","Lowndes",2015,112865,113523,-658,-0.579618227143398
"2156","Lowndes",2016,114628,112865,1763,1.5620431488947
"2157","Lowndes",2017,115489,114628,861,0.751125379488432
"2158","Lowndes",2018,116321,115489,832,0.720414931292158
"2159","Lowndes",2019,117406,116321,1085,0.932763645429458
"2160","Lowndes",2020,118268,117406,862,0.734204384784423
"2161","Lowndes",2021,119276,118268,1008,0.852301552406399
"2162","Lowndes",2022,119739,119276,463,0.388175324457561
"2163","Lumpkin",2000,21251,20547,704,3.4262909427167
"2164","Lumpkin",2001,22152,21251,901,4.23980047997741
"2165","Lumpkin",2002,23048,22152,896,4.04478150957024
"2166","Lumpkin",2003,24162,23048,1114,4.8333911836168
"2167","Lumpkin",2004,24916,24162,754,3.12060259912259
"2168","Lumpkin",2005,25884,24916,968,3.88505378070316
"2169","Lumpkin",2006,27300,25884,1416,5.47056096430227
"2170","Lumpkin",2007,28228,27300,928,3.3992673992674
"2171","Lumpkin",2008,29128,28228,900,3.18832365027632
"2172","Lumpkin",2009,29723,29128,595,2.04270804723977
"2173","Lumpkin",2010,29998,29723,275,0.925209433771827
"2174","Lumpkin",2011,30031,29998,33,0.110007333822255
"2175","Lumpkin",2012,30611,30031,580,1.93133761779495
"2176","Lumpkin",2013,30918,30611,307,1.0029074515697
"2177","Lumpkin",2014,31176,30918,258,0.834465359984475
"2178","Lumpkin",2015,31408,31176,232,0.744162176032846
"2179","Lumpkin",2016,31445,31408,37,0.117804381049414
"2180","Lumpkin",2017,32873,31445,1428,4.54126252186357
"2181","Lumpkin",2018,32955,32873,82,0.249444833145743
"2182","Lumpkin",2019,33610,32955,655,1.98755879229252
"2183","Lumpkin",2020,34186,33610,576,1.71377566200536
"2184","Lumpkin",2021,34278,34186,92,0.269116012402738
"2185","Lumpkin",2022,34796,34278,518,1.51117334733648
"2186","Macon",2000,14025,14029,-4,-0.02851236723929
"2187","Macon",2001,14186,14025,161,1.14795008912656
"2188","Macon",2002,14245,14186,59,0.415903002960665
"2189","Macon",2003,14294,14245,49,0.343980343980344
"2190","Macon",2004,14304,14294,10,0.0699594235343501
"2191","Macon",2005,14241,14304,-63,-0.440436241610738
"2192","Macon",2006,14364,14241,123,0.863703391615757
"2193","Macon",2007,14402,14364,38,0.264550264550265
"2194","Macon",2008,14496,14402,94,0.652687126787946
"2195","Macon",2009,14842,14496,346,2.38686534216336
"2196","Macon",2010,14662,14842,-180,-1.21277455868481
"2197","Macon",2011,14405,14662,-257,-1.75283044605102
"2198","Macon",2012,14263,14405,-142,-0.985768830267268
"2199","Macon",2013,14009,14263,-254,-1.78083152212017
"2200","Macon",2014,13792,14009,-217,-1.54900421157827
"2201","Macon",2015,13632,13792,-160,-1.16009280742459
"2202","Macon",2016,13450,13632,-182,-1.33509389671362
"2203","Macon",2017,13314,13450,-136,-1.01115241635688
"2204","Macon",2018,13143,13314,-171,-1.28436232537179
"2205","Macon",2019,12947,13143,-196,-1.49128813817241
"2206","Macon",2020,12712,12947,-235,-1.81509229937437
"2207","Macon",2021,12004,12712,-708,-5.56954059156702
"2208","Macon",2022,11765,12004,-239,-1.99100299900033
"2209","Madison",2000,25800,25334,466,1.83942527828215
"2210","Madison",2001,26046,25800,246,0.953488372093023
"2211","Madison",2002,26512,26046,466,1.78914228672349
"2212","Madison",2003,26857,26512,345,1.30129752564876
"2213","Madison",2004,26859,26857,2,0.00744684812153256
"2214","Madison",2005,27123,26859,264,0.982910756171116
"2215","Madison",2006,27347,27123,224,0.8258673450577
"2216","Madison",2007,27649,27347,302,1.10432588583757
"2217","Madison",2008,27820,27649,171,0.618467214004123
"2218","Madison",2009,28008,27820,188,0.675772825305536
"2219","Madison",2010,28167,28008,159,0.567694944301628
"2220","Madison",2011,27921,28167,-246,-0.873362445414847
"2221","Madison",2012,27922,27921,1,0.00358153361269295
"2222","Madison",2013,28057,27922,135,0.483489721366664
"2223","Madison",2014,28312,28057,255,0.908864098086039
"2224","Madison",2015,28441,28312,129,0.455637185645663
"2225","Madison",2016,28824,28441,383,1.34664744558911
"2226","Madison",2017,29302,28824,478,1.65834027199556
"2227","Madison",2018,29650,29302,348,1.18763224353286
"2228","Madison",2019,29880,29650,230,0.775716694772344
"2229","Madison",2020,30457,29880,577,1.93105756358768
"2230","Madison",2021,30885,30457,428,1.40525987457727
"2231","Madison",2022,31473,30885,588,1.90383681398737
"2232","Marion",2000,7189,7020,169,2.40740740740741
"2233","Marion",2001,7322,7189,133,1.85004868549172
"2234","Marion",2002,7400,7322,78,1.06528270964217
"2235","Marion",2003,7521,7400,121,1.63513513513514
"2236","Marion",2004,7637,7521,116,1.54234809200904
"2237","Marion",2005,7818,7637,181,2.37004059185544
"2238","Marion",2006,8089,7818,271,3.46635968278332
"2239","Marion",2007,8255,8089,166,2.05216961305477
"2240","Marion",2008,8357,8255,102,1.23561477892187
"2241","Marion",2009,8561,8357,204,2.44106736867297
"2242","Marion",2010,8753,8561,192,2.24272865319472
"2243","Marion",2011,8746,8753,-7,-0.0799725808294299
"2244","Marion",2012,8711,8746,-35,-0.400182940772925
"2245","Marion",2013,8640,8711,-71,-0.815061416599702
"2246","Marion",2014,8797,8640,157,1.81712962962963
"2247","Marion",2015,8761,8797,-36,-0.40923041946118
"2248","Marion",2016,8524,8761,-237,-2.70517064262071
"2249","Marion",2017,8450,8524,-74,-0.868137024870953
"2250","Marion",2018,8351,8450,-99,-1.17159763313609
"2251","Marion",2019,8359,8351,8,0.0957969105496348
"2252","Marion",2020,8516,8359,157,1.8782150974997
"2253","Marion",2021,7440,8516,-1076,-12.6350399248473
"2254","Marion",2022,7449,7440,9,0.120967741935484
"2255","McDuffie",2000,21269,21212,57,0.268715821233264
"2256","McDuffie",2001,21323,21269,54,0.253890638958108
"2257","McDuffie",2002,21141,21323,-182,-0.853538432678329
"2258","McDuffie",2003,21155,21141,14,0.0662220330164136
"2259","McDuffie",2004,21256,21155,101,0.477428503899787
"2260","McDuffie",2005,21419,21256,163,0.766842303349642
"2261","McDuffie",2006,21564,21419,145,0.676969046173958
"2262","McDuffie",2007,21527,21564,-37,-0.171582266740864
"2263","McDuffie",2008,21790,21527,263,1.22172155897245
"2264","McDuffie",2009,21836,21790,46,0.211106011932079
"2265","McDuffie",2010,21876,21836,40,0.183183733284484
"2266","McDuffie",2011,21673,21876,-203,-0.927957579082099
"2267","McDuffie",2012,21663,21673,-10,-0.0461403589719928
"2268","McDuffie",2013,21565,21663,-98,-0.452384249642247
"2269","McDuffie",2014,21370,21565,-195,-0.904242986320427
"2270","McDuffie",2015,21540,21370,170,0.795507721104352
"2271","McDuffie",2016,21490,21540,-50,-0.232126276694522
"2272","McDuffie",2017,21498,21490,8,0.0372266170311773
"2273","McDuffie",2018,21531,21498,33,0.153502651409433
"2274","McDuffie",2019,21312,21531,-219,-1.01713807997771
"2275","McDuffie",2020,21162,21312,-150,-0.703828828828829
"2276","McDuffie",2021,21633,21162,471,2.22568755316133
"2277","McDuffie",2022,21713,21633,80,0.369805389913558
"2278","McIntosh",2000,10948,10625,323,3.04
"2279","McIntosh",2001,11401,10948,453,4.13774205334308
"2280","McIntosh",2002,11648,11401,247,2.16647662485747
"2281","McIntosh",2003,11878,11648,230,1.97458791208791
"2282","McIntosh",2004,12182,11878,304,2.55935342650278
"2283","McIntosh",2005,12408,12182,226,1.85519619110163
"2284","McIntosh",2006,12950,12408,542,4.36814958091554
"2285","McIntosh",2007,13623,12950,673,5.1969111969112
"2286","McIntosh",2008,13973,13623,350,2.56918446744476
"2287","McIntosh",2009,14268,13973,295,2.11121448507837
"2288","McIntosh",2010,14271,14268,3,0.0210260723296888
"2289","McIntosh",2011,14170,14271,-101,-0.707728960829655
"2290","McIntosh",2012,13839,14170,-331,-2.33592095977417
"2291","McIntosh",2013,14007,13839,168,1.21396054628225
"2292","McIntosh",2014,14214,14007,207,1.47783251231527
"2293","McIntosh",2015,13969,14214,-245,-1.72365273673843
"2294","McIntosh",2016,13927,13969,-42,-0.300665759896915
"2295","McIntosh",2017,14106,13927,179,1.28527321031091
"2296","McIntosh",2018,14340,14106,234,1.65886856656742
"2297","McIntosh",2019,14378,14340,38,0.264993026499303
"2298","McIntosh",2020,14387,14378,9,0.0625956322158854
"2299","McIntosh",2021,11123,14387,-3264,-22.6871481198304
"2300","McIntosh",2022,11180,11123,57,0.512451676705925
"2301","Meriwether",2000,22526,22502,24,0.106657186027909
"2302","Meriwether",2001,22524,22526,-2,-0.00887862913966084
"2303","Meriwether",2002,22726,22524,202,0.896821168531344
"2304","Meriwether",2003,22615,22726,-111,-0.488427351931708
"2305","Meriwether",2004,22563,22615,-52,-0.229935883263321
"2306","Meriwether",2005,22587,22563,24,0.106368833931658
"2307","Meriwether",2006,22694,22587,107,0.473723823438261
"2308","Meriwether",2007,22506,22694,-188,-0.828412796333833
"2309","Meriwether",2008,22632,22506,126,0.559850706478272
"2310","Meriwether",2009,22446,22632,-186,-0.821845174973489
"2311","Meriwether",2010,21849,22446,-597,-2.65971665330126
"2312","Meriwether",2011,21617,21849,-232,-1.06183349352373
"2313","Meriwether",2012,21273,21617,-344,-1.59134014895684
"2314","Meriwether",2013,21232,21273,-41,-0.192732571804635
"2315","Meriwether",2014,21198,21232,-34,-0.160135644310475
"2316","Meriwether",2015,21190,21198,-8,-0.0377394093782432
"2317","Meriwether",2016,21074,21190,-116,-0.547428032090609
"2318","Meriwether",2017,21049,21074,-25,-0.11862959096517
"2319","Meriwether",2018,21068,21049,19,0.0902655708109649
"2320","Meriwether",2019,21167,21068,99,0.469906967913423
"2321","Meriwether",2020,21164,21167,-3,-0.0141730051495252
"2322","Meriwether",2021,20793,21164,-371,-1.75297675297675
"2323","Meriwether",2022,20845,20793,52,0.250084162939451
"2324","Miller",2000,6351,6399,-48,-0.750117205813408
"2325","Miller",2001,6372,6351,21,0.330656589513462
"2326","Miller",2002,6336,6372,-36,-0.564971751412429
"2327","Miller",2003,6206,6336,-130,-2.05176767676768
"2328","Miller",2004,6135,6206,-71,-1.14405414115372
"2329","Miller",2005,6096,6135,-39,-0.635696821515892
"2330","Miller",2006,6104,6096,8,0.131233595800525
"2331","Miller",2007,6124,6104,20,0.327653997378768
"2332","Miller",2008,6158,6124,34,0.555192684519922
"2333","Miller",2009,6131,6158,-27,-0.438454043520624
"2334","Miller",2010,6123,6131,-8,-0.130484423421954
"2335","Miller",2011,6141,6123,18,0.293973542381186
"2336","Miller",2012,5969,6141,-172,-2.80084676762742
"2337","Miller",2013,5932,5969,-37,-0.619869324845033
"2338","Miller",2014,5958,5932,26,0.438300741739717
"2339","Miller",2015,5854,5958,-104,-1.7455521987244
"2340","Miller",2016,5926,5854,72,1.22992825418517
"2341","Miller",2017,5838,5926,-88,-1.48498143773203
"2342","Miller",2018,5686,5838,-152,-2.6036313806098
"2343","Miller",2019,5718,5686,32,0.562785789658811
"2344","Miller",2020,5622,5718,-96,-1.67890870933893
"2345","Miller",2021,5919,5622,297,5.28281750266809
"2346","Miller",2022,5807,5919,-112,-1.89221152221659
"2347","Mitchell",2000,23965,23615,350,1.48210882913402
"2348","Mitchell",2001,23872,23965,-93,-0.388065929480492
"2349","Mitchell",2002,23698,23872,-174,-0.728887399463807
"2350","Mitchell",2003,23594,23698,-104,-0.438855599628661
"2351","Mitchell",2004,23520,23594,-74,-0.313639060778164
"2352","Mitchell",2005,23363,23520,-157,-0.667517006802721
"2353","Mitchell",2006,23579,23363,216,0.924538800667723
"2354","Mitchell",2007,23974,23579,395,1.67521947495653
"2355","Mitchell",2008,23840,23974,-134,-0.55893885042129
"2356","Mitchell",2009,23592,23840,-248,-1.04026845637584
"2357","Mitchell",2010,23500,23592,-92,-0.389962699220075
"2358","Mitchell",2011,23462,23500,-38,-0.161702127659574
"2359","Mitchell",2012,23144,23462,-318,-1.35538317279004
"2360","Mitchell",2013,23045,23144,-99,-0.427756653992395
"2361","Mitchell",2014,22771,23045,-274,-1.18897808635279
"2362","Mitchell",2015,22574,22771,-197,-0.865135479337754
"2363","Mitchell",2016,22459,22574,-115,-0.509435633915124
"2364","Mitchell",2017,22292,22459,-167,-0.743577185092836
"2365","Mitchell",2018,22192,22292,-100,-0.448591422931993
"2366","Mitchell",2019,21863,22192,-329,-1.482516222062
"2367","Mitchell",2020,21602,21863,-261,-1.19379774047477
"2368","Mitchell",2021,21521,21602,-81,-0.374965280992501
"2369","Mitchell",2022,21116,21521,-405,-1.88188281213698
"2370","Monroe",2000,21824,21430,394,1.8385440970602
"2371","Monroe",2001,22092,21824,268,1.22800586510264
"2372","Monroe",2002,22767,22092,675,3.05540467137425
"2373","Monroe",2003,23499,22767,732,3.21517986559494
"2374","Monroe",2004,23648,23499,149,0.634069534873824
"2375","Monroe",2005,24080,23648,432,1.82679296346414
"2376","Monroe",2006,24924,24080,844,3.50498338870432
"2377","Monroe",2007,25726,24924,802,3.21778205745466
"2378","Monroe",2008,25969,25726,243,0.944569696027365
"2379","Monroe",2009,26233,25969,264,1.01659671146367
"2380","Monroe",2010,26467,26233,234,0.892006251667747
"2381","Monroe",2011,26625,26467,158,0.596969811463332
"2382","Monroe",2012,26637,26625,12,0.0450704225352113
"2383","Monroe",2013,26984,26637,347,1.30269925291887
"2384","Monroe",2014,27051,26984,67,0.248295286095464
"2385","Monroe",2015,27103,27051,52,0.192229492440206
"2386","Monroe",2016,27306,27103,203,0.748994576246172
"2387","Monroe",2017,27113,27306,-193,-0.706804365340951
"2388","Monroe",2018,27520,27113,407,1.50112492162431
"2389","Monroe",2019,27578,27520,58,0.210755813953488
"2390","Monroe",2020,28042,27578,464,1.68250054391181
"2391","Monroe",2021,28712,28042,670,2.38927323300763
"2392","Monroe",2022,29427,28712,715,2.4902479799387
"2393","Montgomery",2000,8234,8215,19,0.231284236153378
"2394","Montgomery",2001,8505,8234,271,3.29123147923245
"2395","Montgomery",2002,8532,8505,27,0.317460317460317
"2396","Montgomery",2003,8805,8532,273,3.19971870604782
"2397","Montgomery",2004,9040,8805,235,2.66893810335037
"2398","Montgomery",2005,8997,9040,-43,-0.475663716814159
"2399","Montgomery",2006,9165,8997,168,1.86728909636546
"2400","Montgomery",2007,9175,9165,10,0.10911074740862
"2401","Montgomery",2008,9100,9175,-75,-0.817438692098093
"2402","Montgomery",2009,9136,9100,36,0.395604395604396
"2403","Montgomery",2010,9116,9136,-20,-0.218914185639229
"2404","Montgomery",2011,9065,9116,-51,-0.559455901711277
"2405","Montgomery",2012,8913,9065,-152,-1.67677881963596
"2406","Montgomery",2013,9021,8913,108,1.2117132278694
"2407","Montgomery",2014,8991,9021,-30,-0.33255736614566
"2408","Montgomery",2015,8951,8991,-40,-0.444889333778223
"2409","Montgomery",2016,9060,8951,109,1.21774103452128
"2410","Montgomery",2017,9031,9060,-29,-0.320088300220751
"2411","Montgomery",2018,9193,9031,162,1.79382128225003
"2412","Montgomery",2019,9172,9193,-21,-0.228434678559774
"2413","Montgomery",2020,9012,9172,-160,-1.74443959877889
"2414","Montgomery",2021,8653,9012,-359,-3.98357745228584
"2415","Montgomery",2022,8655,8653,2,0.0231133710851728
"2416","Morgan",2000,15531,15274,257,1.6825978787482
"2417","Morgan",2001,15951,15531,420,2.70426888159166
"2418","Morgan",2002,16244,15951,293,1.83687543100746
"2419","Morgan",2003,16397,16244,153,0.941886234917508
"2420","Morgan",2004,16604,16397,207,1.26242605354638
"2421","Morgan",2005,16925,16604,321,1.93326909178511
"2422","Morgan",2006,17316,16925,391,2.31019202363368
"2423","Morgan",2007,17648,17316,332,1.91730191730192
"2424","Morgan",2008,17958,17648,310,1.75657298277425
"2425","Morgan",2009,17921,17958,-37,-0.206036306938412
"2426","Morgan",2010,17862,17921,-59,-0.329222699626137
"2427","Morgan",2011,17961,17862,99,0.554249244205576
"2428","Morgan",2012,17881,17961,-80,-0.445409498357552
"2429","Morgan",2013,17781,17881,-100,-0.559252838208154
"2430","Morgan",2014,17956,17781,175,0.984196614363647
"2431","Morgan",2015,18046,17956,90,0.501225217197594
"2432","Morgan",2016,18170,18046,124,0.687132882633271
"2433","Morgan",2017,18412,18170,242,1.33186571271326
"2434","Morgan",2018,18853,18412,441,2.39517705844015
"2435","Morgan",2019,19276,18853,423,2.24367474672466
"2436","Morgan",2020,19636,19276,360,1.86760738742478
"2437","Morgan",2021,20635,19636,999,5.08759421470768
"2438","Morgan",2022,21031,20635,396,1.91906954204022
"2439","Murray",2000,36737,35495,1242,3.49908437808142
"2440","Murray",2001,37683,36737,946,2.57506056564227
"2441","Murray",2002,38167,37683,484,1.28439880052013
"2442","Murray",2003,38998,38167,831,2.1772735609296
"2443","Murray",2004,39465,38998,467,1.19749730755423
"2444","Murray",2005,39723,39465,258,0.653743823641201
"2445","Murray",2006,40173,39723,450,1.13284495128767
"2446","Murray",2007,40138,40173,-35,-0.087123192193762
"2447","Murray",2008,39869,40138,-269,-0.670187851910907
"2448","Murray",2009,39888,39869,19,0.0476560736411748
"2449","Murray",2010,39559,39888,-329,-0.824809466506217
"2450","Murray",2011,39557,39559,-2,-0.0050557395282995
"2451","Murray",2012,39392,39557,-165,-0.417119599565184
"2452","Murray",2013,39267,39392,-125,-0.317323314378554
"2453","Murray",2014,39410,39267,143,0.364173479002725
"2454","Murray",2015,39565,39410,155,0.393301192590713
"2455","Murray",2016,39315,39565,-250,-0.63187160369013
"2456","Murray",2017,39782,39315,467,1.18784179066514
"2457","Murray",2018,39921,39782,139,0.34940425317983
"2458","Murray",2019,40096,39921,175,0.438365772400491
"2459","Murray",2020,40032,40096,-64,-0.159616919393456
"2460","Murray",2021,39951,40032,-81,-0.202338129496403
"2461","Murray",2022,40472,39951,521,1.30409751946134
"2462","Muscogee",2000,186478,185734,744,0.40057286226539
"2463","Muscogee",2001,186375,186478,-103,-0.0552343976233121
"2464","Muscogee",2002,185139,186375,-1236,-0.66317907444668
"2465","Muscogee",2003,180838,185139,-4301,-2.32311938597486
"2466","Muscogee",2004,185057,180838,4219,2.33302735044626
"2467","Muscogee",2005,186543,185057,1486,0.802995833716098
"2468","Muscogee",2006,189464,186543,2921,1.56585881003308
"2469","Muscogee",2007,184704,189464,-4760,-2.51235063125449
"2470","Muscogee",2008,184763,184704,59,0.0319430006930007
"2471","Muscogee",2009,188796,184763,4033,2.18279633909387
"2472","Muscogee",2010,190417,188796,1621,0.858598699124982
"2473","Muscogee",2011,194107,190417,3690,1.93785218756729
"2474","Muscogee",2012,198413,194107,4306,2.21836409815205
"2475","Muscogee",2013,202824,198413,4411,2.22314062082626
"2476","Muscogee",2014,200887,202824,-1937,-0.955015185579616
"2477","Muscogee",2015,200579,200887,-308,-0.153320025686082
"2478","Muscogee",2016,197485,200579,-3094,-1.54253436301906
"2479","Muscogee",2017,194058,197485,-3427,-1.73532167000025
"2480","Muscogee",2018,194160,194058,102,0.0525616052932628
"2481","Muscogee",2019,195769,194160,1609,0.82869798104656
"2482","Muscogee",2020,196442,195769,673,0.343772507393918
"2483","Muscogee",2021,205617,196442,9175,4.67058979240692
"2484","Muscogee",2022,202616,205617,-3001,-1.45950967089297
"2485","N/A Rates indicate that no population exists for the query selected.",2000,NA,NA,NA,NA
"2486","N/A Rates indicate that no population exists for the query selected.",2001,NA,NA,NA,NA
"2487","N/A Rates indicate that no population exists for the query selected.",2002,NA,NA,NA,NA
"2488","N/A Rates indicate that no population exists for the query selected.",2003,NA,NA,NA,NA
"2489","N/A Rates indicate that no population exists for the query selected.",2004,NA,NA,NA,NA
"2490","N/A Rates indicate that no population exists for the query selected.",2005,NA,NA,NA,NA
"2491","N/A Rates indicate that no population exists for the query selected.",2006,NA,NA,NA,NA
"2492","N/A Rates indicate that no population exists for the query selected.",2007,NA,NA,NA,NA
"2493","N/A Rates indicate that no population exists for the query selected.",2008,NA,NA,NA,NA
"2494","N/A Rates indicate that no population exists for the query selected.",2009,NA,NA,NA,NA
"2495","N/A Rates indicate that no population exists for the query selected.",2010,NA,NA,NA,NA
"2496","N/A Rates indicate that no population exists for the query selected.",2011,NA,NA,NA,NA
"2497","N/A Rates indicate that no population exists for the query selected.",2012,NA,NA,NA,NA
"2498","N/A Rates indicate that no population exists for the query selected.",2013,NA,NA,NA,NA
"2499","N/A Rates indicate that no population exists for the query selected.",2014,NA,NA,NA,NA
"2500","N/A Rates indicate that no population exists for the query selected.",2015,NA,NA,NA,NA
"2501","N/A Rates indicate that no population exists for the query selected.",2016,NA,NA,NA,NA
"2502","N/A Rates indicate that no population exists for the query selected.",2017,NA,NA,NA,NA
"2503","N/A Rates indicate that no population exists for the query selected.",2018,NA,NA,NA,NA
"2504","N/A Rates indicate that no population exists for the query selected.",2019,NA,NA,NA,NA
"2505","N/A Rates indicate that no population exists for the query selected.",2020,NA,NA,NA,NA
"2506","N/A Rates indicate that no population exists for the query selected.",2021,NA,NA,NA,NA
"2507","N/A Rates indicate that no population exists for the query selected.",2022,NA,NA,NA,NA
"2508","Newton",2000,62768,59506,3262,5.48180015460626
"2509","Newton",2001,66823,62768,4055,6.46029824114198
"2510","Newton",2002,71102,66823,4279,6.40348383041767
"2511","Newton",2003,75610,71102,4508,6.34018733650249
"2512","Newton",2004,80603,75610,4993,6.60362385927787
"2513","Newton",2005,85647,80603,5044,6.25783159435753
"2514","Newton",2006,90647,85647,5000,5.83791609746985
"2515","Newton",2007,95699,90647,5052,5.57326773086809
"2516","Newton",2008,98240,95699,2541,2.65520015883134
"2517","Newton",2009,99494,98240,1254,1.2764657980456
"2518","Newton",2010,100086,99494,592,0.595010754417352
"2519","Newton",2011,100814,100086,728,0.727374457966149
"2520","Newton",2012,101505,100814,691,0.685420675699804
"2521","Newton",2013,102446,101505,941,0.927047928673464
"2522","Newton",2014,103675,102446,1229,1.19965640434961
"2523","Newton",2015,105473,103675,1798,1.73426573426573
"2524","Newton",2016,106999,105473,1526,1.44681577275701
"2525","Newton",2017,108078,106999,1079,1.00842063944523
"2526","Newton",2018,109541,108078,1463,1.35365199207979
"2527","Newton",2019,111744,109541,2203,2.01111912434614
"2528","Newton",2020,113295,111744,1551,1.3879939862543
"2529","Newton",2021,115355,113295,2060,1.81826205922591
"2530","Newton",2022,117621,115355,2266,1.96437085518616
"2531","Oconee",2000,25874,25637,237,0.924445137886648
"2532","Oconee",2001,26135,25874,261,1.00873463708742
"2533","Oconee",2002,26501,26135,366,1.40042089152478
"2534","Oconee",2003,27334,26501,833,3.14327761216558
"2535","Oconee",2004,27904,27334,570,2.08531499231726
"2536","Oconee",2005,28616,27904,712,2.55160550458716
"2537","Oconee",2006,29720,28616,1104,3.8579815487839
"2538","Oconee",2007,30755,29720,1035,3.48250336473755
"2539","Oconee",2008,31697,30755,942,3.062916598927
"2540","Oconee",2009,32386,31697,689,2.17370729091081
"2541","Oconee",2010,32984,32386,598,1.84647687272278
"2542","Oconee",2011,33366,32984,382,1.15813727868057
"2543","Oconee",2012,33619,33366,253,0.758256908229935
"2544","Oconee",2013,34035,33619,416,1.23739552039026
"2545","Oconee",2014,35093,34035,1058,3.10856471279565
"2546","Oconee",2015,35965,35093,872,2.48482603368193
"2547","Oconee",2016,36838,35965,873,2.42735993326846
"2548","Oconee",2017,38028,36838,1190,3.23035995439492
"2549","Oconee",2018,39272,38028,1244,3.27127379825392
"2550","Oconee",2019,40280,39272,1008,2.56671419841108
"2551","Oconee",2020,41124,40280,844,2.09533267130089
"2552","Oconee",2021,43023,41124,1899,4.61774146483805
"2553","Oconee",2022,43588,43023,565,1.31325105176301
"2554","Oglethorpe",2000,12688,12312,376,3.05393112410656
"2555","Oglethorpe",2001,12902,12688,214,1.68663303909206
"2556","Oglethorpe",2002,13152,12902,250,1.9376840799876
"2557","Oglethorpe",2003,13369,13152,217,1.64993917274939
"2558","Oglethorpe",2004,13591,13369,222,1.66055800733039
"2559","Oglethorpe",2005,13699,13591,108,0.794643514090207
"2560","Oglethorpe",2006,14030,13699,331,2.41623476166144
"2561","Oglethorpe",2007,14382,14030,352,2.50890947968639
"2562","Oglethorpe",2008,14663,14382,281,1.95383117786122
"2563","Oglethorpe",2009,14784,14663,121,0.825206301575394
"2564","Oglethorpe",2010,14919,14784,135,0.913149350649351
"2565","Oglethorpe",2011,14686,14919,-233,-1.56176687445539
"2566","Oglethorpe",2012,14618,14686,-68,-0.463026011167098
"2567","Oglethorpe",2013,14548,14618,-70,-0.478861677384047
"2568","Oglethorpe",2014,14673,14548,125,0.859224635688755
"2569","Oglethorpe",2015,14871,14673,198,1.34941729707626
"2570","Oglethorpe",2016,14921,14871,50,0.336224867191177
"2571","Oglethorpe",2017,14877,14921,-44,-0.294886401715703
"2572","Oglethorpe",2018,15054,14877,177,1.18975599919339
"2573","Oglethorpe",2019,15259,15054,205,1.36176431513219
"2574","Oglethorpe",2020,15383,15259,124,0.812635166131463
"2575","Oglethorpe",2021,15140,15383,-243,-1.57966586491582
"2576","Oglethorpe",2022,15469,15140,329,2.17305151915456
"2577","Paulding",2000,83026,77863,5163,6.63087731014731
"2578","Paulding",2001,88910,83026,5884,7.08693662226291
"2579","Paulding",2002,94561,88910,5651,6.35586548194804
"2580","Paulding",2003,100340,94561,5779,6.11139899112742
"2581","Paulding",2004,106350,100340,6010,5.98963524018338
"2582","Paulding",2005,113132,106350,6782,6.37705688763517
"2583","Paulding",2006,122635,113132,9503,8.39992221475798
"2584","Paulding",2007,131172,122635,8537,6.96130794634484
"2585","Paulding",2008,137066,131172,5894,4.49333699265087
"2586","Paulding",2009,140761,137066,3695,2.69578159426845
"2587","Paulding",2010,142741,140761,1980,1.40663962319108
"2588","Paulding",2011,143542,142741,801,0.561156220006866
"2589","Paulding",2012,144800,143542,1258,0.876398545373479
"2590","Paulding",2013,146950,144800,2150,1.48480662983425
"2591","Paulding",2014,148987,146950,2037,1.38618577747533
"2592","Paulding",2015,152238,148987,3251,2.18206957654023
"2593","Paulding",2016,155825,152238,3587,2.35617914055623
"2594","Paulding",2017,159445,155825,3620,2.32311888336275
"2595","Paulding",2018,164044,159445,4599,2.88438019379723
"2596","Paulding",2019,168667,164044,4623,2.81814635097901
"2597","Paulding",2020,173359,168667,4692,2.78181268416466
"2598","Paulding",2021,173780,173359,421,0.242848655102994
"2599","Paulding",2022,178421,173780,4641,2.67061802278743
"2600","Peach",2000,23871,23348,523,2.24002055850608
"2601","Peach",2001,24063,23871,192,0.804323237401031
"2602","Peach",2002,24348,24063,285,1.18439097369405
"2603","Peach",2003,24595,24348,247,1.01445703959257
"2604","Peach",2004,24818,24595,223,0.906688351290913
"2605","Peach",2005,24756,24818,-62,-0.24981867999033
"2606","Peach",2006,25510,24756,754,3.04572628857651
"2607","Peach",2007,26467,25510,957,3.75147001176009
"2608","Peach",2008,27222,26467,755,2.85260890920769
"2609","Peach",2009,27474,27222,252,0.925721842627287
"2610","Peach",2010,27741,27474,267,0.971827910024023
"2611","Peach",2011,27823,27741,82,0.295591362964565
"2612","Peach",2012,27622,27823,-201,-0.72242389390073
"2613","Peach",2013,27014,27622,-608,-2.20114401563971
"2614","Peach",2014,26922,27014,-92,-0.340564151921226
"2615","Peach",2015,26720,26922,-202,-0.750315726914791
"2616","Peach",2016,26655,26720,-65,-0.243263473053892
"2617","Peach",2017,27099,26655,444,1.66572875633089
"2618","Peach",2018,27297,27099,198,0.730654267685154
"2619","Peach",2019,27546,27297,249,0.912188152544236
"2620","Peach",2020,27950,27546,404,1.46663762433747
"2621","Peach",2021,28417,27950,467,1.67084078711986
"2622","Peach",2022,28562,28417,145,0.510257944188338
"2623","Pickens",2000,23412,21840,1572,7.1978021978022
"2624","Pickens",2001,24334,23412,922,3.93815137536306
"2625","Pickens",2002,25258,24334,924,3.79715624229473
"2626","Pickens",2003,26209,25258,951,3.76514371684219
"2627","Pickens",2004,26810,26209,601,2.29310542180167
"2628","Pickens",2005,27277,26810,467,1.74188735546438
"2629","Pickens",2006,28169,27277,892,3.27015434248634
"2630","Pickens",2007,29095,28169,926,3.28730164365082
"2631","Pickens",2008,29531,29095,436,1.49853926791545
"2632","Pickens",2009,29542,29531,11,0.0372489925840642
"2633","Pickens",2010,29436,29542,-106,-0.358811184076907
"2634","Pickens",2011,29415,29436,-21,-0.0713412148389727
"2635","Pickens",2012,29268,29415,-147,-0.499745028046915
"2636","Pickens",2013,29584,29268,316,1.0796774634413
"2637","Pickens",2014,29997,29584,413,1.3960248783126
"2638","Pickens",2015,30309,29997,312,1.04010401040104
"2639","Pickens",2016,30832,30309,523,1.72556006466726
"2640","Pickens",2017,31588,30832,756,2.45199792423456
"2641","Pickens",2018,31980,31588,392,1.24097758642522
"2642","Pickens",2019,32591,31980,611,1.91056910569106
"2643","Pickens",2020,33127,32591,536,1.64462581694333
"2644","Pickens",2021,34024,33127,897,2.70776104084282
"2645","Pickens",2022,34826,34024,802,2.35715965201035
"2646","Pierce",2000,15702,15387,315,2.04718268668356
"2647","Pierce",2001,15811,15702,109,0.69417908546682
"2648","Pierce",2002,15995,15811,184,1.16374675858579
"2649","Pierce",2003,16278,15995,283,1.76930290715849
"2650","Pierce",2004,16755,16278,477,2.93033542204202
"2651","Pierce",2005,17179,16755,424,2.53058788421367
"2652","Pierce",2006,17502,17179,323,1.88020257290878
"2653","Pierce",2007,17933,17502,431,2.46257570563364
"2654","Pierce",2008,18210,17933,277,1.544638376178
"2655","Pierce",2009,18564,18210,354,1.94398682042834
"2656","Pierce",2010,18818,18564,254,1.36823960353372
"2657","Pierce",2011,18770,18818,-48,-0.255074928260176
"2658","Pierce",2012,18844,18770,74,0.394246137453383
"2659","Pierce",2013,18938,18844,94,0.498832519634897
"2660","Pierce",2014,18991,18938,53,0.279860597739994
"2661","Pierce",2015,19103,18991,112,0.589753040914117
"2662","Pierce",2016,19171,19103,68,0.355965031670418
"2663","Pierce",2017,19307,19171,136,0.7094048302123
"2664","Pierce",2018,19389,19307,82,0.424716424094888
"2665","Pierce",2019,19465,19389,76,0.391974831089793
"2666","Pierce",2020,19522,19465,57,0.292833290521449
"2667","Pierce",2021,19976,19522,454,2.32558139534884
"2668","Pierce",2022,20168,19976,192,0.961153384060873
"2669","Pike",2000,13571,13312,259,1.94561298076923
"2670","Pike",2001,13834,13571,263,1.93795593545059
"2671","Pike",2002,14445,13834,611,4.4166546190545
"2672","Pike",2003,14881,14445,436,3.01834544825199
"2673","Pike",2004,15474,14881,593,3.98494724816881
"2674","Pike",2005,15908,15474,434,2.80470466589117
"2675","Pike",2006,16590,15908,682,4.28715111893387
"2676","Pike",2007,17220,16590,630,3.79746835443038
"2677","Pike",2008,17619,17220,399,2.31707317073171
"2678","Pike",2009,17721,17619,102,0.578920483568874
"2679","Pike",2010,17905,17721,184,1.038316122115
"2680","Pike",2011,17751,17905,-154,-0.860094945545937
"2681","Pike",2012,17810,17751,59,0.332375640808969
"2682","Pike",2013,17796,17810,-14,-0.0786075238629983
"2683","Pike",2014,17784,17796,-12,-0.0674308833445718
"2684","Pike",2015,17941,17784,157,0.882816014394962
"2685","Pike",2016,17941,17941,0,0
"2686","Pike",2017,18217,17941,276,1.53837578730283
"2687","Pike",2018,18634,18217,417,2.28907064829555
"2688","Pike",2019,18962,18634,328,1.76022324782655
"2689","Pike",2020,19121,18962,159,0.838519143550258
"2690","Pike",2021,19477,19121,356,1.86182731028712
"2691","Pike",2022,19990,19477,513,2.63387585357088
"2692","Polk",2000,38178,37812,366,0.96794668359251
"2693","Polk",2001,38612,38178,434,1.13678034470114
"2694","Polk",2002,39109,38612,497,1.28716461203771
"2695","Polk",2003,39246,39109,137,0.350302999309622
"2696","Polk",2004,39564,39246,318,0.810273658462009
"2697","Polk",2005,39860,39564,296,0.748154888282277
"2698","Polk",2006,40372,39860,512,1.28449573507275
"2699","Polk",2007,40789,40372,417,1.03289408500941
"2700","Polk",2008,41407,40789,618,1.51511436907009
"2701","Polk",2009,41386,41407,-21,-0.0507160625015094
"2702","Polk",2010,41523,41386,137,0.331029816846277
"2703","Polk",2011,41211,41523,-312,-0.751390795462756
"2704","Polk",2012,41188,41211,-23,-0.0558103418990075
"2705","Polk",2013,41183,41188,-5,-0.0121394580945907
"2706","Polk",2014,41133,41183,-50,-0.121409319379356
"2707","Polk",2015,41524,41133,391,0.950574964140714
"2708","Polk",2016,41776,41524,252,0.606877950101146
"2709","Polk",2017,42085,41776,309,0.739659134431252
"2710","Polk",2018,42470,42085,385,0.914815254841392
"2711","Polk",2019,42613,42470,143,0.336708264657405
"2712","Polk",2020,42840,42613,227,0.532701288339239
"2713","Polk",2021,43496,42840,656,1.531279178338
"2714","Polk",2022,43709,43496,213,0.489700202317454
"2715","Pulaski",2000,9655,9458,197,2.08289278917319
"2716","Pulaski",2001,9882,9655,227,2.35111341273951
"2717","Pulaski",2002,10168,9882,286,2.89415098158268
"2718","Pulaski",2003,10351,10168,183,1.79976396538159
"2719","Pulaski",2004,10646,10351,295,2.84996618684185
"2720","Pulaski",2005,10890,10646,244,2.29194063498027
"2721","Pulaski",2006,11183,10890,293,2.69054178145087
"2722","Pulaski",2007,11445,11183,262,2.34284181346687
"2723","Pulaski",2008,11638,11445,193,1.68632590650939
"2724","Pulaski",2009,11903,11638,265,2.27702354356419
"2725","Pulaski",2010,11991,11903,88,0.739309417793834
"2726","Pulaski",2011,11735,11991,-256,-2.13493453423401
"2727","Pulaski",2012,11720,11735,-15,-0.127822752449936
"2728","Pulaski",2013,11542,11720,-178,-1.51877133105802
"2729","Pulaski",2014,11483,11542,-59,-0.511176572517761
"2730","Pulaski",2015,11396,11483,-87,-0.757641731254899
"2731","Pulaski",2016,11251,11396,-145,-1.27237627237627
"2732","Pulaski",2017,11201,11251,-50,-0.444404941782953
"2733","Pulaski",2018,11069,11201,-132,-1.17846620837425
"2734","Pulaski",2019,11137,11069,68,0.614328304273195
"2735","Pulaski",2020,11191,11137,54,0.484870252312113
"2736","Pulaski",2021,9917,11191,-1274,-11.3841479760522
"2737","Pulaski",2022,9984,9917,67,0.67560754260361
"2738","Putnam",2000,18834,18667,167,0.894626881662827
"2739","Putnam",2001,19152,18834,318,1.68843580758203
"2740","Putnam",2002,19366,19152,214,1.11737677527151
"2741","Putnam",2003,19494,19366,128,0.660952184240421
"2742","Putnam",2004,19810,19494,316,1.62101159331076
"2743","Putnam",2005,20012,19810,202,1.01968702675416
"2744","Putnam",2006,20368,20012,356,1.77893264041575
"2745","Putnam",2007,20800,20368,432,2.1209740769835
"2746","Putnam",2008,21075,20800,275,1.32211538461538
"2747","Putnam",2009,21179,21075,104,0.493475682087782
"2748","Putnam",2010,21205,21179,26,0.122763114405779
"2749","Putnam",2011,21345,21205,140,0.660221645838246
"2750","Putnam",2012,21198,21345,-147,-0.688685874912157
"2751","Putnam",2013,21371,21198,173,0.81611472780451
"2752","Putnam",2014,21192,21371,-179,-0.837583641383183
"2753","Putnam",2015,21353,21192,161,0.759720649301623
"2754","Putnam",2016,21477,21353,124,0.58071465367864
"2755","Putnam",2017,21730,21477,253,1.17800437677515
"2756","Putnam",2018,21809,21730,79,0.363552692130695
"2757","Putnam",2019,22119,21809,310,1.42143151909762
"2758","Putnam",2020,22520,22119,401,1.81292101812921
"2759","Putnam",2021,22585,22520,65,0.288632326820604
"2760","Putnam",2022,22984,22585,399,1.76665928713748
"2761","Quitman",2000,2596,2563,33,1.28755364806867
"2762","Quitman",2001,2607,2596,11,0.423728813559322
"2763","Quitman",2002,2547,2607,-60,-2.30149597238205
"2764","Quitman",2003,2478,2547,-69,-2.70906949352179
"2765","Quitman",2004,2457,2478,-21,-0.847457627118644
"2766","Quitman",2005,2519,2457,62,2.52340252340252
"2767","Quitman",2006,2545,2519,26,1.03215561730846
"2768","Quitman",2007,2529,2545,-16,-0.628683693516699
"2769","Quitman",2008,2547,2529,18,0.711743772241993
"2770","Quitman",2009,2497,2547,-50,-1.96309383588536
"2771","Quitman",2010,2521,2497,24,0.961153384060873
"2772","Quitman",2011,2464,2521,-57,-2.26100753669179
"2773","Quitman",2012,2404,2464,-60,-2.43506493506494
"2774","Quitman",2013,2367,2404,-37,-1.53910149750416
"2775","Quitman",2014,2315,2367,-52,-2.19687367976341
"2776","Quitman",2015,2302,2315,-13,-0.561555075593952
"2777","Quitman",2016,2335,2302,33,1.43353605560382
"2778","Quitman",2017,2358,2335,23,0.985010706638116
"2779","Quitman",2018,2279,2358,-79,-3.35029686174724
"2780","Quitman",2019,2299,2279,20,0.877577885037297
"2781","Quitman",2020,2271,2299,-28,-1.21792083514572
"2782","Quitman",2021,2243,2271,-28,-1.23293703214443
"2783","Quitman",2022,2249,2243,6,0.267498885421311
"2784","Rabun",2000,15070,14798,272,1.83808622786863
"2785","Rabun",2001,15310,15070,240,1.59256801592568
"2786","Rabun",2002,15458,15310,148,0.966688438928805
"2787","Rabun",2003,15691,15458,233,1.50731013067667
"2788","Rabun",2004,15757,15691,66,0.420623287234721
"2789","Rabun",2005,15934,15757,177,1.1233102747985
"2790","Rabun",2006,16090,15934,156,0.979038533952554
"2791","Rabun",2007,16306,16090,216,1.34244872591672
"2792","Rabun",2008,16359,16306,53,0.325033729915369
"2793","Rabun",2009,16295,16359,-64,-0.391221957332355
"2794","Rabun",2010,16280,16295,-15,-0.0920527769254373
"2795","Rabun",2011,16274,16280,-6,-0.0368550368550369
"2796","Rabun",2012,16297,16274,23,0.141329728401131
"2797","Rabun",2013,16235,16297,-62,-0.380438117444929
"2798","Rabun",2014,16243,16235,8,0.0492762550046196
"2799","Rabun",2015,16281,16243,38,0.233946930985655
"2800","Rabun",2016,16559,16281,278,1.70751182359806
"2801","Rabun",2017,16602,16559,43,0.259677516758258
"2802","Rabun",2018,16867,16602,265,1.59619322973136
"2803","Rabun",2019,17137,16867,270,1.60075887828304
"2804","Rabun",2020,17273,17137,136,0.79360448153119
"2805","Rabun",2021,17119,17273,-154,-0.891564870028368
"2806","Rabun",2022,17206,17119,87,0.508207255096676
"2807","Randolph",2000,7773,7827,-54,-0.689919509390571
"2808","Randolph",2001,7786,7773,13,0.167245593721858
"2809","Randolph",2002,7747,7786,-39,-0.500899049576162
"2810","Randolph",2003,7699,7747,-48,-0.619594681812314
"2811","Randolph",2004,7726,7699,27,0.350694895440966
"2812","Randolph",2005,7707,7726,-19,-0.245922857882475
"2813","Randolph",2006,7786,7707,79,1.02504216945634
"2814","Randolph",2007,7758,7786,-28,-0.359619830464937
"2815","Randolph",2008,7645,7758,-113,-1.45656096932199
"2816","Randolph",2009,7736,7645,91,1.19032047089601
"2817","Randolph",2010,7696,7736,-40,-0.517063081695967
"2818","Randolph",2011,7558,7696,-138,-1.79313929313929
"2819","Randolph",2012,7327,7558,-231,-3.0563641174914
"2820","Randolph",2013,7197,7327,-130,-1.77425958782585
"2821","Randolph",2014,7313,7197,116,1.61178268723079
"2822","Randolph",2015,7193,7313,-120,-1.64091344181594
"2823","Randolph",2016,7177,7193,-16,-0.222438481857361
"2824","Randolph",2017,7075,7177,-102,-1.42120663229762
"2825","Randolph",2018,6833,7075,-242,-3.42049469964664
"2826","Randolph",2019,6778,6833,-55,-0.804917313039661
"2827","Randolph",2020,6682,6778,-96,-1.41634700501623
"2828","Randolph",2021,6287,6682,-395,-5.91140377132595
"2829","Randolph",2022,6116,6287,-171,-2.71989820264037
"2830","Rates based on 1-4 events are not shown and indicated by an *.",2000,NA,NA,NA,NA
"2831","Rates based on 1-4 events are not shown and indicated by an *.",2001,NA,NA,NA,NA
"2832","Rates based on 1-4 events are not shown and indicated by an *.",2002,NA,NA,NA,NA
"2833","Rates based on 1-4 events are not shown and indicated by an *.",2003,NA,NA,NA,NA
"2834","Rates based on 1-4 events are not shown and indicated by an *.",2004,NA,NA,NA,NA
"2835","Rates based on 1-4 events are not shown and indicated by an *.",2005,NA,NA,NA,NA
"2836","Rates based on 1-4 events are not shown and indicated by an *.",2006,NA,NA,NA,NA
"2837","Rates based on 1-4 events are not shown and indicated by an *.",2007,NA,NA,NA,NA
"2838","Rates based on 1-4 events are not shown and indicated by an *.",2008,NA,NA,NA,NA
"2839","Rates based on 1-4 events are not shown and indicated by an *.",2009,NA,NA,NA,NA
"2840","Rates based on 1-4 events are not shown and indicated by an *.",2010,NA,NA,NA,NA
"2841","Rates based on 1-4 events are not shown and indicated by an *.",2011,NA,NA,NA,NA
"2842","Rates based on 1-4 events are not shown and indicated by an *.",2012,NA,NA,NA,NA
"2843","Rates based on 1-4 events are not shown and indicated by an *.",2013,NA,NA,NA,NA
"2844","Rates based on 1-4 events are not shown and indicated by an *.",2014,NA,NA,NA,NA
"2845","Rates based on 1-4 events are not shown and indicated by an *.",2015,NA,NA,NA,NA
"2846","Rates based on 1-4 events are not shown and indicated by an *.",2016,NA,NA,NA,NA
"2847","Rates based on 1-4 events are not shown and indicated by an *.",2017,NA,NA,NA,NA
"2848","Rates based on 1-4 events are not shown and indicated by an *.",2018,NA,NA,NA,NA
"2849","Rates based on 1-4 events are not shown and indicated by an *.",2019,NA,NA,NA,NA
"2850","Rates based on 1-4 events are not shown and indicated by an *.",2020,NA,NA,NA,NA
"2851","Rates based on 1-4 events are not shown and indicated by an *.",2021,NA,NA,NA,NA
"2852","Rates based on 1-4 events are not shown and indicated by an *.",2022,NA,NA,NA,NA
"2853","Richmond",2000,199547,199395,152,0.0762305975576118
"2854","Richmond",2001,199443,199547,-104,-0.0521180473773096
"2855","Richmond",2002,198670,199443,-773,-0.387579408653099
"2856","Richmond",2003,196958,198670,-1712,-0.861730507877385
"2857","Richmond",2004,196883,196958,-75,-0.0380791843946425
"2858","Richmond",2005,195837,196883,-1046,-0.531279998781002
"2859","Richmond",2006,196449,195837,612,0.312504787144411
"2860","Richmond",2007,196483,196449,34,0.017307290950832
"2861","Richmond",2008,198423,196483,1940,0.987362774387606
"2862","Richmond",2009,198489,198423,66,0.0332622730227847
"2863","Richmond",2010,201005,198489,2516,1.26757654076548
"2864","Richmond",2011,201217,201005,212,0.105470013183752
"2865","Richmond",2012,202587,201217,1370,0.680856985244785
"2866","Richmond",2013,202003,202587,-584,-0.288271211874405
"2867","Richmond",2014,201368,202003,-635,-0.314351767052965
"2868","Richmond",2015,201793,201368,425,0.21105637439911
"2869","Richmond",2016,201647,201793,-146,-0.0723513699682348
"2870","Richmond",2017,201800,201647,153,0.0758751679915893
"2871","Richmond",2018,201554,201800,-246,-0.121902874132805
"2872","Richmond",2019,202518,201554,964,0.478283735376127
"2873","Richmond",2020,202079,202518,-439,-0.216770854936351
"2874","Richmond",2021,205673,202079,3594,1.77851236397646
"2875","Richmond",2022,206640,205673,967,0.470163803707827
"2876","Rockdale",2000,70724,69214,1510,2.18163955269165
"2877","Rockdale",2001,71875,70724,1151,1.62745319834851
"2878","Rockdale",2002,73158,71875,1283,1.78504347826087
"2879","Rockdale",2003,74860,73158,1702,2.32647147270292
"2880","Rockdale",2004,76577,74860,1717,2.29361474752872
"2881","Rockdale",2005,78086,76577,1509,1.97056557451976
"2882","Rockdale",2006,79911,78086,1825,2.33716671362344
"2883","Rockdale",2007,82146,79911,2235,2.79686150842813
"2884","Rockdale",2008,83558,82146,1412,1.71889075548414
"2885","Rockdale",2009,84625,83558,1067,1.27695732305704
"2886","Rockdale",2010,85434,84625,809,0.955982274741507
"2887","Rockdale",2011,85765,85434,331,0.387433574455135
"2888","Rockdale",2012,85820,85765,55,0.0641287238383956
"2889","Rockdale",2013,86919,85820,1099,1.28058727569331
"2890","Rockdale",2014,87754,86919,835,0.96066452674329
"2891","Rockdale",2015,88856,87754,1102,1.25578321216127
"2892","Rockdale",2016,89355,88856,499,0.561582785630683
"2893","Rockdale",2017,90312,89355,957,1.07100889709585
"2894","Rockdale",2018,90594,90312,282,0.312250863672602
"2895","Rockdale",2019,90896,90594,302,0.333355409850542
"2896","Rockdale",2020,90939,90896,43,0.0473068121809541
"2897","Rockdale",2021,94082,90939,3143,3.45616292239853
"2898","Rockdale",2022,94984,94082,902,0.958738122063732
"2899","Schley",2000,3791,3706,85,2.29357798165138
"2900","Schley",2001,3860,3791,69,1.82010023740438
"2901","Schley",2002,3920,3860,60,1.55440414507772
"2902","Schley",2003,3976,3920,56,1.42857142857143
"2903","Schley",2004,4070,3976,94,2.36418511066398
"2904","Schley",2005,4270,4070,200,4.91400491400491
"2905","Schley",2006,4374,4270,104,2.43559718969555
"2906","Schley",2007,4601,4374,227,5.18975765889346
"2907","Schley",2008,4835,4601,234,5.08585090197783
"2908","Schley",2009,4954,4835,119,2.4612202688728
"2909","Schley",2010,5010,4954,56,1.13039967702866
"2910","Schley",2011,5020,5010,10,0.199600798403194
"2911","Schley",2012,4990,5020,-30,-0.597609561752988
"2912","Schley",2013,5089,4990,99,1.98396793587174
"2913","Schley",2014,5163,5089,74,1.45411672234231
"2914","Schley",2015,5168,5163,5,0.0968429207824908
"2915","Schley",2016,5098,5168,-70,-1.35448916408669
"2916","Schley",2017,5213,5098,115,2.25578658297372
"2917","Schley",2018,5236,5213,23,0.441204680606177
"2918","Schley",2019,5257,5236,21,0.401069518716578
"2919","Schley",2020,5196,5257,-61,-1.16035761841354
"2920","Schley",2021,4478,5196,-718,-13.8183217859892
"2921","Schley",2022,4496,4478,18,0.401965163019205
"2922","Screven",2000,15341,15256,85,0.557157839538542
"2923","Screven",2001,15057,15341,-284,-1.85124828889903
"2924","Screven",2002,15226,15057,169,1.12240154081158
"2925","Screven",2003,15040,15226,-186,-1.22159464074609
"2926","Screven",2004,15047,15040,7,0.0465425531914894
"2927","Screven",2005,15065,15047,18,0.119625174453379
"2928","Screven",2006,14884,15065,-181,-1.20146033853302
"2929","Screven",2007,14865,14884,-19,-0.127653856490191
"2930","Screven",2008,14843,14865,-22,-0.147998654557686
"2931","Screven",2009,14905,14843,62,0.417705315637001
"2932","Screven",2010,14500,14905,-405,-2.71720899027172
"2933","Screven",2011,14367,14500,-133,-0.917241379310345
"2934","Screven",2012,14202,14367,-165,-1.14846523282522
"2935","Screven",2013,14240,14202,38,0.267567948176313
"2936","Screven",2014,14085,14240,-155,-1.08848314606742
"2937","Screven",2015,14162,14085,77,0.546680866169684
"2938","Screven",2016,14044,14162,-118,-0.833215647507414
"2939","Screven",2017,13953,14044,-91,-0.6479635431501
"2940","Screven",2018,13938,13953,-15,-0.107503762631692
"2941","Screven",2019,13966,13938,28,0.20088965418281
"2942","Screven",2020,14012,13966,46,0.329371330373765
"2943","Screven",2021,14105,14012,93,0.663716814159292
"2944","Screven",2022,13977,14105,-128,-0.907479617157037
"2945","Seminole",2000,9329,9343,-14,-0.149844803596275
"2946","Seminole",2001,9251,9329,-78,-0.836102476149641
"2947","Seminole",2002,9210,9251,-41,-0.443195330234569
"2948","Seminole",2003,9033,9210,-177,-1.92182410423453
"2949","Seminole",2004,9065,9033,32,0.354256614635226
"2950","Seminole",2005,8905,9065,-160,-1.76503033645891
"2951","Seminole",2006,8869,8905,-36,-0.404267265581134
"2952","Seminole",2007,8800,8869,-69,-0.777990754312775
"2953","Seminole",2008,8827,8800,27,0.306818181818182
"2954","Seminole",2009,8760,8827,-67,-0.759034779653336
"2955","Seminole",2010,8727,8760,-33,-0.376712328767123
"2956","Seminole",2011,8791,8727,64,0.733356250716168
"2957","Seminole",2012,8947,8791,156,1.77454214537595
"2958","Seminole",2013,8945,8947,-2,-0.0223538616295965
"2959","Seminole",2014,8686,8945,-259,-2.89547233091112
"2960","Seminole",2015,8647,8686,-39,-0.448998388210914
"2961","Seminole",2016,8468,8647,-179,-2.0700821094021
"2962","Seminole",2017,8292,8468,-176,-2.07841284837034
"2963","Seminole",2018,8315,8292,23,0.277375783888085
"2964","Seminole",2019,8090,8315,-225,-2.70595309681299
"2965","Seminole",2020,8060,8090,-30,-0.370828182941904
"2966","Seminole",2021,9197,8060,1137,14.106699751861
"2967","Seminole",2022,9127,9197,-70,-0.761117755789931
"2968","Spalding",2000,58497,58227,270,0.463702406100263
"2969","Spalding",2001,58927,58497,430,0.735080431475118
"2970","Spalding",2002,59699,58927,772,1.31009554194172
"2971","Spalding",2003,60222,59699,523,0.87606157557078
"2972","Spalding",2004,60588,60222,366,0.607751320115572
"2973","Spalding",2005,61091,60588,503,0.83019739882485
"2974","Spalding",2006,61971,61091,880,1.44047404691362
"2975","Spalding",2007,62682,61971,711,1.14731083894079
"2976","Spalding",2008,63651,62682,969,1.54589834402221
"2977","Spalding",2009,64135,63651,484,0.760396537367834
"2978","Spalding",2010,64081,64135,-54,-0.0841973961175645
"2979","Spalding",2011,64033,64081,-48,-0.0749051981086438
"2980","Spalding",2012,63865,64033,-168,-0.262364718192182
"2981","Spalding",2013,63829,63865,-36,-0.0563689031550928
"2982","Spalding",2014,63988,63829,159,0.249103072271225
"2983","Spalding",2015,64051,63988,63,0.0984559604925924
"2984","Spalding",2016,64806,64051,755,1.17874818504005
"2985","Spalding",2017,65380,64806,574,0.885720457982285
"2986","Spalding",2018,66100,65380,720,1.10125420617926
"2987","Spalding",2019,66703,66100,603,0.912254160363086
"2988","Spalding",2020,67414,66703,711,1.06591907410461
"2989","Spalding",2021,67909,67414,495,0.73426884623372
"2990","Spalding",2022,68919,67909,1010,1.48728445419606
"2991","Stephens",2000,25482,25270,212,0.838939453897903
"2992","Stephens",2001,25594,25482,112,0.43952593987913
"2993","Stephens",2002,25625,25594,31,0.121122138001094
"2994","Stephens",2003,25432,25625,-193,-0.753170731707317
"2995","Stephens",2004,25314,25432,-118,-0.463982384397609
"2996","Stephens",2005,25332,25314,18,0.0711068973690448
"2997","Stephens",2006,25488,25332,156,0.615821885362387
"2998","Stephens",2007,25620,25488,132,0.51789077212806
"2999","Stephens",2008,26004,25620,384,1.49882903981265
"3000","Stephens",2009,26069,26004,65,0.249961544377788
"3001","Stephens",2010,26193,26069,124,0.475660746480494
"3002","Stephens",2011,25960,26193,-233,-0.889550643301646
"3003","Stephens",2012,25891,25960,-69,-0.265793528505393
"3004","Stephens",2013,25683,25891,-208,-0.803367965702368
"3005","Stephens",2014,25480,25683,-203,-0.790406105205778
"3006","Stephens",2015,25586,25480,106,0.416012558869702
"3007","Stephens",2016,25751,25586,165,0.644883920894239
"3008","Stephens",2017,25890,25751,139,0.539784862723778
"3009","Stephens",2018,26035,25890,145,0.56006179992275
"3010","Stephens",2019,25925,26035,-110,-0.422508162089495
"3011","Stephens",2020,26107,25925,182,0.702025072324012
"3012","Stephens",2021,26865,26107,758,2.90343586011415
"3013","Stephens",2022,26767,26865,-98,-0.364786897450214
"3014","Stewart",2000,5284,5270,14,0.265654648956357
"3015","Stewart",2001,5358,5284,74,1.4004542013626
"3016","Stewart",2002,5424,5358,66,1.23180291153415
"3017","Stewart",2003,5472,5424,48,0.884955752212389
"3018","Stewart",2004,5534,5472,62,1.13304093567251
"3019","Stewart",2005,5595,5534,61,1.10227683411637
"3020","Stewart",2006,5627,5595,32,0.571939231456658
"3021","Stewart",2007,5691,5627,64,1.13737337835436
"3022","Stewart",2008,5814,5691,123,2.16130732735899
"3023","Stewart",2009,5968,5814,154,2.64877880976952
"3024","Stewart",2010,6053,5968,85,1.42426273458445
"3025","Stewart",2011,5910,6053,-143,-2.36246489344127
"3026","Stewart",2012,6042,5910,132,2.23350253807107
"3027","Stewart",2013,5868,6042,-174,-2.8798411122145
"3028","Stewart",2014,5744,5868,-124,-2.11315610088616
"3029","Stewart",2015,5851,5744,107,1.86281337047354
"3030","Stewart",2016,5705,5851,-146,-2.49529994872671
"3031","Stewart",2017,5985,5705,280,4.9079754601227
"3032","Stewart",2018,6199,5985,214,3.57560568086884
"3033","Stewart",2019,6621,6199,422,6.80754960477496
"3034","Stewart",2020,6689,6621,68,1.02703519105875
"3035","Stewart",2021,5341,6689,-1348,-20.1524891613096
"3036","Stewart",2022,4648,5341,-693,-12.9750982961992
"3037","Sumter",2000,33448,32957,491,1.4898200685742
"3038","Sumter",2001,33447,33448,-1,-0.00298971537909591
"3039","Sumter",2002,33362,33447,-85,-0.254133405088648
"3040","Sumter",2003,33178,33362,-184,-0.551525687908399
"3041","Sumter",2004,32902,33178,-276,-0.831876544698294
"3042","Sumter",2005,32622,32902,-280,-0.851012096529086
"3043","Sumter",2006,32785,32622,163,0.499662804242536
"3044","Sumter",2007,32987,32785,202,0.616135427787098
"3045","Sumter",2008,33012,32987,25,0.0757874314123746
"3046","Sumter",2009,32724,33012,-288,-0.872410032715376
"3047","Sumter",2010,32816,32724,92,0.281139225033614
"3048","Sumter",2011,32511,32816,-305,-0.929424670892248
"3049","Sumter",2012,31554,32511,-957,-2.94361908277198
"3050","Sumter",2013,31364,31554,-190,-0.60214235913038
"3051","Sumter",2014,31232,31364,-132,-0.420864685626833
"3052","Sumter",2015,30779,31232,-453,-1.45043545081967
"3053","Sumter",2016,30389,30779,-390,-1.26709769648137
"3054","Sumter",2017,29847,30389,-542,-1.78354009674553
"3055","Sumter",2018,29733,29847,-114,-0.381947934465775
"3056","Sumter",2019,29524,29733,-209,-0.702922678505364
"3057","Sumter",2020,29282,29524,-242,-0.819672131147541
"3058","Sumter",2021,29283,29282,1,0.00341506727682535
"3059","Sumter",2022,28877,29283,-406,-1.386469965509
"3060","Talbot",2000,6563,6478,85,1.3121333744983
"3061","Talbot",2001,6675,6563,112,1.70653664482706
"3062","Talbot",2002,6749,6675,74,1.10861423220974
"3063","Talbot",2003,6696,6749,-53,-0.785301526152023
"3064","Talbot",2004,6775,6696,79,1.17980884109916
"3065","Talbot",2005,6906,6775,131,1.93357933579336
"3066","Talbot",2006,6959,6906,53,0.767448595424269
"3067","Talbot",2007,7026,6959,67,0.962782008909326
"3068","Talbot",2008,6899,7026,-127,-1.80757187588955
"3069","Talbot",2009,6873,6899,-26,-0.376866212494564
"3070","Talbot",2010,6844,6873,-29,-0.421940928270042
"3071","Talbot",2011,6751,6844,-93,-1.35885447106955
"3072","Talbot",2012,6517,6751,-234,-3.46615316249445
"3073","Talbot",2013,6456,6517,-61,-0.936013503145619
"3074","Talbot",2014,6390,6456,-66,-1.02230483271375
"3075","Talbot",2015,6337,6390,-53,-0.829420970266041
"3076","Talbot",2016,6171,6337,-166,-2.61953605807164
"3077","Talbot",2017,6249,6171,78,1.26397666504618
"3078","Talbot",2018,6272,6249,23,0.368058889422308
"3079","Talbot",2019,6195,6272,-77,-1.22767857142857
"3080","Talbot",2020,6143,6195,-52,-0.839386602098466
"3081","Talbot",2021,5742,6143,-401,-6.52775516848445
"3082","Talbot",2022,5747,5742,5,0.0870776732845698
"3083","Taliaferro",2000,2076,2050,26,1.26829268292683
"3084","Taliaferro",2001,2031,2076,-45,-2.16763005780347
"3085","Taliaferro",2002,2040,2031,9,0.443131462333826
"3086","Taliaferro",2003,1923,2040,-117,-5.73529411764706
"3087","Taliaferro",2004,1903,1923,-20,-1.04004160166407
"3088","Taliaferro",2005,1858,1903,-45,-2.3646873357856
"3089","Taliaferro",2006,1863,1858,5,0.269106566200215
"3090","Taliaferro",2007,1851,1863,-12,-0.644122383252818
"3091","Taliaferro",2008,1820,1851,-31,-1.67477039438142
"3092","Taliaferro",2009,1774,1820,-46,-2.52747252747253
"3093","Taliaferro",2010,1698,1774,-76,-4.28410372040586
"3094","Taliaferro",2011,1703,1698,5,0.294464075382803
"3095","Taliaferro",2012,1680,1703,-23,-1.35055783910746
"3096","Taliaferro",2013,1703,1680,23,1.36904761904762
"3097","Taliaferro",2014,1693,1703,-10,-0.587199060481503
"3098","Taliaferro",2015,1639,1693,-54,-3.18960425280567
"3099","Taliaferro",2016,1593,1639,-46,-2.80658938377059
"3100","Taliaferro",2017,1628,1593,35,2.19711236660389
"3101","Taliaferro",2018,1608,1628,-20,-1.22850122850123
"3102","Taliaferro",2019,1537,1608,-71,-4.41542288557214
"3103","Taliaferro",2020,1562,1537,25,1.62654521795706
"3104","Taliaferro",2021,1558,1562,-4,-0.256081946222791
"3105","Taliaferro",2022,1600,1558,42,2.69576379974326
"3106","Tattnall",2000,22322,22049,273,1.23815139008572
"3107","Tattnall",2001,22242,22322,-80,-0.358390825194875
"3108","Tattnall",2002,22276,22242,34,0.152863951083536
"3109","Tattnall",2003,22485,22276,209,0.938229484647154
"3110","Tattnall",2004,23034,22485,549,2.44162775183456
"3111","Tattnall",2005,23165,23034,131,0.568724494225927
"3112","Tattnall",2006,23417,23165,252,1.08784804662206
"3113","Tattnall",2007,23444,23417,27,0.115300849809967
"3114","Tattnall",2008,23801,23444,357,1.52277768298925
"3115","Tattnall",2009,25068,23801,1267,5.32330574345616
"3116","Tattnall",2010,25585,25068,517,2.06239029838838
"3117","Tattnall",2011,25688,25585,103,0.402579636505765
"3118","Tattnall",2012,25384,25688,-304,-1.18343195266272
"3119","Tattnall",2013,25526,25384,142,0.559407500787898
"3120","Tattnall",2014,25224,25526,-302,-1.18310741988561
"3121","Tattnall",2015,25229,25224,5,0.0198223913732953
"3122","Tattnall",2016,25092,25229,-137,-0.543025882912521
"3123","Tattnall",2017,25334,25092,242,0.964450820978798
"3124","Tattnall",2018,25391,25334,57,0.224994079103181
"3125","Tattnall",2019,25286,25391,-105,-0.413532353983695
"3126","Tattnall",2020,25365,25286,79,0.3124258482955
"3127","Tattnall",2021,23052,25365,-2313,-9.11886457717327
"3128","Tattnall",2022,24064,23052,1012,4.39007461391636
"3129","Taylor",2000,8821,8790,31,0.352673492605233
"3130","Taylor",2001,8756,8821,-65,-0.736877904999433
"3131","Taylor",2002,8837,8756,81,0.925079945180448
"3132","Taylor",2003,8879,8837,42,0.475274414394025
"3133","Taylor",2004,8918,8879,39,0.439238653001464
"3134","Taylor",2005,8860,8918,-58,-0.65037003812514
"3135","Taylor",2006,8798,8860,-62,-0.699774266365689
"3136","Taylor",2007,8868,8798,70,0.795635371675381
"3137","Taylor",2008,8945,8868,77,0.86829048263419
"3138","Taylor",2009,8854,8945,-91,-1.01732811626607
"3139","Taylor",2010,8911,8854,57,0.643776824034335
"3140","Taylor",2011,8499,8911,-412,-4.62349904612277
"3141","Taylor",2012,8420,8499,-79,-0.92952112013178
"3142","Taylor",2013,8464,8420,44,0.522565320665083
"3143","Taylor",2014,8442,8464,-22,-0.25992438563327
"3144","Taylor",2015,8330,8442,-112,-1.32669983416252
"3145","Taylor",2016,8232,8330,-98,-1.17647058823529
"3146","Taylor",2017,8142,8232,-90,-1.0932944606414
"3147","Taylor",2018,8039,8142,-103,-1.26504544338
"3148","Taylor",2019,8020,8039,-19,-0.23634780445329
"3149","Taylor",2020,8074,8020,54,0.673316708229426
"3150","Taylor",2021,7799,8074,-275,-3.40599455040872
"3151","Taylor",2022,7737,7799,-62,-0.794973714578792
"3152","Telfair",2000,11893,11747,146,1.2428705201328
"3153","Telfair",2001,12155,11893,262,2.20297654082233
"3154","Telfair",2002,12347,12155,192,1.57959687371452
"3155","Telfair",2003,13887,12347,1540,12.4726654247995
"3156","Telfair",2004,14685,13887,798,5.74638150788507
"3157","Telfair",2005,15070,14685,385,2.62172284644195
"3158","Telfair",2006,15401,15070,331,2.19641672196417
"3159","Telfair",2007,15932,15401,531,3.44782806311279
"3160","Telfair",2008,16230,15932,298,1.87044940999247
"3161","Telfair",2009,16200,16230,-30,-0.184842883548983
"3162","Telfair",2010,16497,16200,297,1.83333333333333
"3163","Telfair",2011,16057,16497,-440,-2.66715160332182
"3164","Telfair",2012,16349,16057,292,1.81852151709535
"3165","Telfair",2013,16591,16349,242,1.48021285705548
"3166","Telfair",2014,16518,16591,-73,-0.439997589054307
"3167","Telfair",2015,16400,16518,-118,-0.714372200024216
"3168","Telfair",2016,15965,16400,-435,-2.65243902439024
"3169","Telfair",2017,15989,15965,24,0.150328844347009
"3170","Telfair",2018,15876,15989,-113,-0.706735880918131
"3171","Telfair",2019,15860,15876,-16,-0.100781053162006
"3172","Telfair",2020,15781,15860,-79,-0.498108448928121
"3173","Telfair",2021,12414,15781,-3367,-21.3357835371649
"3174","Telfair",2022,12354,12414,-60,-0.483325277912035
"3175","Terrell",2000,10935,10954,-19,-0.173452620047471
"3176","Terrell",2001,10822,10935,-113,-1.03337905807042
"3177","Terrell",2002,10607,10822,-215,-1.98669377194604
"3178","Terrell",2003,10641,10607,34,0.320543037616668
"3179","Terrell",2004,10453,10641,-188,-1.76675124518372
"3180","Terrell",2005,10134,10453,-319,-3.05175547689658
"3181","Terrell",2006,9969,10134,-165,-1.62818235642392
"3182","Terrell",2007,9701,9969,-268,-2.68833383488815
"3183","Terrell",2008,9648,9701,-53,-0.546335429337182
"3184","Terrell",2009,9596,9648,-52,-0.538971807628524
"3185","Terrell",2010,9321,9596,-275,-2.86577740725302
"3186","Terrell",2011,9319,9321,-2,-0.0214569252226156
"3187","Terrell",2012,9045,9319,-274,-2.94022963837322
"3188","Terrell",2013,9022,9045,-23,-0.25428413488115
"3189","Terrell",2014,9132,9022,110,1.21924185324762
"3190","Terrell",2015,9113,9132,-19,-0.208059570740254
"3191","Terrell",2016,8967,9113,-146,-1.60210688028092
"3192","Terrell",2017,8729,8967,-238,-2.65417642466823
"3193","Terrell",2018,8611,8729,-118,-1.35181578645893
"3194","Terrell",2019,8531,8611,-80,-0.929044245732203
"3195","Terrell",2020,8523,8531,-8,-0.0937756417770484
"3196","Terrell",2021,8964,8523,441,5.17423442449842
"3197","Terrell",2022,8754,8964,-210,-2.34270414993307
"3198","Thomas",2000,42829,42360,469,1.10717658168083
"3199","Thomas",2001,42674,42829,-155,-0.361904317168274
"3200","Thomas",2002,42555,42674,-119,-0.278858321226039
"3201","Thomas",2003,42956,42555,401,0.942309951827047
"3202","Thomas",2004,42762,42956,-194,-0.451624918521278
"3203","Thomas",2005,43556,42762,794,1.85678873766428
"3204","Thomas",2006,43901,43556,345,0.792083754247406
"3205","Thomas",2007,44269,43901,368,0.838249698184552
"3206","Thomas",2008,44627,44269,358,0.808692312905193
"3207","Thomas",2009,44689,44627,62,0.138929347704305
"3208","Thomas",2010,44769,44689,80,0.179014970126877
"3209","Thomas",2011,44702,44769,-67,-0.149657128816815
"3210","Thomas",2012,44724,44702,22,0.0492148002326518
"3211","Thomas",2013,44869,44724,145,0.324210714605134
"3212","Thomas",2014,44959,44869,90,0.20058392208429
"3213","Thomas",2015,45063,44959,104,0.231321871038057
"3214","Thomas",2016,45248,45063,185,0.410536360206822
"3215","Thomas",2017,44779,45248,-469,-1.0365099009901
"3216","Thomas",2018,44448,44779,-331,-0.739185779048215
"3217","Thomas",2019,44451,44448,3,0.00674946004319654
"3218","Thomas",2020,44372,44451,-79,-0.177723785741603
"3219","Thomas",2021,45842,44372,1470,3.31290002704408
"3220","Thomas",2022,45561,45842,-281,-0.612975001090703
"3221","Tift",2000,38348,38234,114,0.298163937856358
"3222","Tift",2001,38133,38348,-215,-0.560655053718577
"3223","Tift",2002,38217,38133,84,0.220281645818582
"3224","Tift",2003,38215,38217,-2,-0.0052332731506921
"3225","Tift",2004,38622,38215,407,1.06502682192856
"3226","Tift",2005,38789,38622,167,0.43239604370566
"3227","Tift",2006,39503,38789,714,1.84072804145505
"3228","Tift",2007,39720,39503,217,0.549325367693593
"3229","Tift",2008,39806,39720,86,0.216515609264854
"3230","Tift",2009,39748,39806,-58,-0.145706677385319
"3231","Tift",2010,40339,39748,591,1.4868672637617
"3232","Tift",2011,41461,40339,1122,2.7814274027616
"3233","Tift",2012,41064,41461,-397,-0.957526350063916
"3234","Tift",2013,40286,41064,-778,-1.89460354568478
"3235","Tift",2014,40704,40286,418,1.03758129374969
"3236","Tift",2015,40764,40704,60,0.147405660377358
"3237","Tift",2016,40828,40764,64,0.157001275635365
"3238","Tift",2017,40598,40828,-230,-0.563338885078867
"3239","Tift",2018,40571,40598,-27,-0.0665057391989753
"3240","Tift",2019,40644,40571,73,0.179931478149417
"3241","Tift",2020,40719,40644,75,0.184529081783289
"3242","Tift",2021,41212,40719,493,1.21073700238218
"3243","Tift",2022,41412,41212,200,0.485295544986897
"3244","Toombs",2000,26137,26016,121,0.46509840098401
"3245","Toombs",2001,26040,26137,-97,-0.371121398783334
"3246","Toombs",2002,26031,26040,-9,-0.0345622119815668
"3247","Toombs",2003,26009,26031,-22,-0.0845146171871999
"3248","Toombs",2004,26166,26009,157,0.603637202506825
"3249","Toombs",2005,26539,26166,373,1.42551402583505
"3250","Toombs",2006,26851,26539,312,1.1756283205848
"3251","Toombs",2007,27185,26851,334,1.24390153066925
"3252","Toombs",2008,27345,27185,160,0.58855986757403
"3253","Toombs",2009,27079,27345,-266,-0.972755531175718
"3254","Toombs",2010,27297,27079,218,0.805051885224713
"3255","Toombs",2011,27434,27297,137,0.501886654211085
"3256","Toombs",2012,27315,27434,-119,-0.433768316687322
"3257","Toombs",2013,27273,27315,-42,-0.153761669412411
"3258","Toombs",2014,27282,27273,9,0.0329996700033
"3259","Toombs",2015,27241,27282,-41,-0.150282237372627
"3260","Toombs",2016,27196,27241,-45,-0.16519217356191
"3261","Toombs",2017,26999,27196,-197,-0.724371231063392
"3262","Toombs",2018,26887,26999,-112,-0.414830178895515
"3263","Toombs",2019,26830,26887,-57,-0.211998363521404
"3264","Toombs",2020,26973,26830,143,0.532985464032799
"3265","Toombs",2021,26911,26973,-62,-0.229859489118748
"3266","Toombs",2022,26837,26911,-74,-0.274980491248932
"3267","Towns",2000,9348,9135,213,2.33169129720854
"3268","Towns",2001,9499,9348,151,1.61531878476679
"3269","Towns",2002,9532,9499,33,0.347404989998947
"3270","Towns",2003,9745,9532,213,2.23457826269408
"3271","Towns",2004,9872,9745,127,1.30323242688558
"3272","Towns",2005,9940,9872,68,0.688816855753647
"3273","Towns",2006,10281,9940,341,3.43058350100604
"3274","Towns",2007,10452,10281,171,1.66326232856726
"3275","Towns",2008,10485,10452,33,0.315729047072331
"3276","Towns",2009,10444,10485,-41,-0.39103481163567
"3277","Towns",2010,10488,10444,44,0.421294523171199
"3278","Towns",2011,10611,10488,123,1.17276887871854
"3279","Towns",2012,10495,10611,-116,-1.09320516445198
"3280","Towns",2013,10771,10495,276,2.62982372558361
"3281","Towns",2014,11098,10771,327,3.03592981153096
"3282","Towns",2015,11182,11098,84,0.756893133898
"3283","Towns",2016,11391,11182,209,1.86907529958862
"3284","Towns",2017,11506,11391,115,1.00956895794926
"3285","Towns",2018,11852,11506,346,3.00712671649574
"3286","Towns",2019,12037,11852,185,1.56091798852514
"3287","Towns",2020,12247,12037,210,1.74462075267924
"3288","Towns",2021,12875,12247,628,5.12778639666857
"3289","Towns",2022,12972,12875,97,0.753398058252427
"3290","Treutlen",2000,6862,6702,160,2.38734706057893
"3291","Treutlen",2001,6895,6862,33,0.480909355872923
"3292","Treutlen",2002,6881,6895,-14,-0.203045685279188
"3293","Treutlen",2003,6924,6881,43,0.624909170178753
"3294","Treutlen",2004,6949,6924,25,0.36106296938186
"3295","Treutlen",2005,6679,6949,-270,-3.8854511440495
"3296","Treutlen",2006,6771,6679,92,1.37745171432849
"3297","Treutlen",2007,6773,6771,2,0.0295377344557672
"3298","Treutlen",2008,6847,6773,74,1.09257345341798
"3299","Treutlen",2009,6906,6847,59,0.861691251643055
"3300","Treutlen",2010,6876,6906,-30,-0.434404865334492
"3301","Treutlen",2011,6825,6876,-51,-0.741710296684119
"3302","Treutlen",2012,6769,6825,-56,-0.82051282051282
"3303","Treutlen",2013,6712,6769,-57,-0.842074161619146
"3304","Treutlen",2014,6778,6712,66,0.983313468414779
"3305","Treutlen",2015,6785,6778,7,0.1032753024491
"3306","Treutlen",2016,6637,6785,-148,-2.18128224023581
"3307","Treutlen",2017,6740,6637,103,1.5519059816182
"3308","Treutlen",2018,6809,6740,69,1.02373887240356
"3309","Treutlen",2019,6901,6809,92,1.35115288588633
"3310","Treutlen",2020,6822,6901,-79,-1.14476162874946
"3311","Treutlen",2021,6306,6822,-516,-7.56376429199648
"3312","Treutlen",2022,6365,6306,59,0.935616872819537
"3313","Troup",2000,58923,58376,547,0.937028915992874
"3314","Troup",2001,59844,58923,921,1.56305687083142
"3315","Troup",2002,60224,59844,380,0.634984292493817
"3316","Troup",2003,60791,60224,567,0.941485122210414
"3317","Troup",2004,62001,60791,1210,1.99042621440674
"3318","Troup",2005,63233,62001,1232,1.9870647247625
"3319","Troup",2006,63897,63233,664,1.05008460772065
"3320","Troup",2007,64894,63897,997,1.56032364586757
"3321","Troup",2008,65860,64894,966,1.48858137886399
"3322","Troup",2009,66422,65860,562,0.853325235347707
"3323","Troup",2010,67187,66422,765,1.1517268374936
"3324","Troup",2011,67764,67187,577,0.858797088722521
"3325","Troup",2012,68468,67764,704,1.03889971076088
"3326","Troup",2013,69053,68468,585,0.854413740725595
"3327","Troup",2014,69469,69053,416,0.602435810174793
"3328","Troup",2015,69763,69469,294,0.423210352819243
"3329","Troup",2016,70005,69763,242,0.346888751917205
"3330","Troup",2017,69786,70005,-219,-0.312834797514463
"3331","Troup",2018,70034,69786,248,0.355372137678044
"3332","Troup",2019,69922,70034,-112,-0.159922323442899
"3333","Troup",2020,70214,69922,292,0.417608191985355
"3334","Troup",2021,69720,70214,-494,-0.703563391916142
"3335","Troup",2022,70191,69720,471,0.675559380378657
"3336","Turner",2000,9475,9460,15,0.158562367864693
"3337","Turner",2001,9512,9475,37,0.390501319261214
"3338","Turner",2002,9514,9512,2,0.0210260723296888
"3339","Turner",2003,9407,9514,-107,-1.12465839815009
"3340","Turner",2004,9310,9407,-97,-1.03114701817795
"3341","Turner",2005,9245,9310,-65,-0.698174006444683
"3342","Turner",2006,9133,9245,-112,-1.21146565711195
"3343","Turner",2007,9111,9133,-22,-0.240884703821307
"3344","Turner",2008,9029,9111,-82,-0.900010975743607
"3345","Turner",2009,8900,9029,-129,-1.42872964890907
"3346","Turner",2010,8950,8900,50,0.561797752808989
"3347","Turner",2011,8875,8950,-75,-0.837988826815642
"3348","Turner",2012,8410,8875,-465,-5.23943661971831
"3349","Turner",2013,8134,8410,-276,-3.28180737217598
"3350","Turner",2014,8153,8134,19,0.233587410867962
"3351","Turner",2015,8214,8153,61,0.748190849993867
"3352","Turner",2016,8030,8214,-184,-2.24007791575359
"3353","Turner",2017,7961,8030,-69,-0.859277708592777
"3354","Turner",2018,7912,7961,-49,-0.615500565255621
"3355","Turner",2019,7985,7912,73,0.922649140546006
"3356","Turner",2020,7882,7985,-103,-1.28991859737007
"3357","Turner",2021,8966,7882,1084,13.7528546054301
"3358","Turner",2022,8842,8966,-124,-1.38300245371403
"3359","Twiggs",2000,10556,10548,8,0.0758437618505878
"3360","Twiggs",2001,10418,10556,-138,-1.30731337627889
"3361","Twiggs",2002,10503,10418,85,0.815895565367633
"3362","Twiggs",2003,10461,10503,-42,-0.399885746929449
"3363","Twiggs",2004,10266,10461,-195,-1.86406653283625
"3364","Twiggs",2005,9978,10266,-288,-2.80537697253068
"3365","Twiggs",2006,9715,9978,-263,-2.63579875726599
"3366","Twiggs",2007,9545,9715,-170,-1.74987133299022
"3367","Twiggs",2008,9442,9545,-103,-1.07909900471451
"3368","Twiggs",2009,9257,9442,-185,-1.95933065028596
"3369","Twiggs",2010,8968,9257,-289,-3.12196175866912
"3370","Twiggs",2011,8779,8968,-189,-2.10749330954505
"3371","Twiggs",2012,8447,8779,-332,-3.78175190796218
"3372","Twiggs",2013,8481,8447,34,0.402509766781106
"3373","Twiggs",2014,8320,8481,-161,-1.89836104232991
"3374","Twiggs",2015,8390,8320,70,0.841346153846154
"3375","Twiggs",2016,8171,8390,-219,-2.61025029797378
"3376","Twiggs",2017,8174,8171,3,0.0367152123363113
"3377","Twiggs",2018,8188,8174,14,0.171274773672621
"3378","Twiggs",2019,8120,8188,-68,-0.830483634587201
"3379","Twiggs",2020,8103,8120,-17,-0.20935960591133
"3380","Twiggs",2021,7856,8103,-247,-3.04825373318524
"3381","Twiggs",2022,7680,7856,-176,-2.24032586558045
"3382","Union",2000,17398,16858,540,3.20322695456163
"3383","Union",2001,17822,17398,424,2.43706173123348
"3384","Union",2002,18349,17822,527,2.95701941420716
"3385","Union",2003,19018,18349,669,3.64597525750722
"3386","Union",2004,19378,19018,360,1.89294352718477
"3387","Union",2005,19856,19378,478,2.46671483125193
"3388","Union",2006,20460,19856,604,3.04190169218372
"3389","Union",2007,20988,20460,528,2.58064516129032
"3390","Union",2008,21285,20988,297,1.41509433962264
"3391","Union",2009,21338,21285,53,0.249001644350482
"3392","Union",2010,21342,21338,4,0.0187458993345206
"3393","Union",2011,21134,21342,-208,-0.974604067097741
"3394","Union",2012,21451,21134,317,1.49995268288067
"3395","Union",2013,21566,21451,115,0.536105542865135
"3396","Union",2014,21984,21566,418,1.93823611239915
"3397","Union",2015,22267,21984,283,1.28729985443959
"3398","Union",2016,22928,22267,661,2.96851843535276
"3399","Union",2017,23459,22928,531,2.31594556873692
"3400","Union",2018,24001,23459,542,2.31041391363656
"3401","Union",2019,24511,24001,510,2.12491146202242
"3402","Union",2020,25358,24511,847,3.45559136714128
"3403","Union",2021,25521,25358,163,0.642795173120909
"3404","Union",2022,26388,25521,867,3.39720230398495
"3405","Upson",2000,27746,27473,273,0.993702908309977
"3406","Upson",2001,27788,27746,42,0.151373170907518
"3407","Upson",2002,27624,27788,-164,-0.590182812724917
"3408","Upson",2003,27648,27624,24,0.0868809730668983
"3409","Upson",2004,27514,27648,-134,-0.484664351851852
"3410","Upson",2005,27440,27514,-74,-0.268953987061132
"3411","Upson",2006,27349,27440,-91,-0.331632653061224
"3412","Upson",2007,27423,27349,74,0.270576620717394
"3413","Upson",2008,27321,27423,-102,-0.371950552455968
"3414","Upson",2009,27360,27321,39,0.142747337213133
"3415","Upson",2010,27087,27360,-273,-0.99780701754386
"3416","Upson",2011,26977,27087,-110,-0.406098866614981
"3417","Upson",2012,26630,26977,-347,-1.28628090595693
"3418","Upson",2013,26566,26630,-64,-0.240330454374765
"3419","Upson",2014,26256,26566,-310,-1.16690506662652
"3420","Upson",2015,26368,26256,112,0.426569165143205
"3421","Upson",2016,26335,26368,-33,-0.125151699029126
"3422","Upson",2017,26135,26335,-200,-0.759445604708563
"3423","Upson",2018,26215,26135,80,0.30610292710924
"3424","Upson",2019,26320,26215,105,0.400534045393859
"3425","Upson",2020,26527,26320,207,0.786474164133739
"3426","Upson",2021,27720,26527,1193,4.49730463301542
"3427","Upson",2022,28086,27720,366,1.32034632034632
"3428","Walker",2000,61268,60960,308,0.505249343832021
"3429","Walker",2001,62109,61268,841,1.37265783116798
"3430","Walker",2002,62841,62109,732,1.17857315364923
"3431","Walker",2003,63478,62841,637,1.01366941964641
"3432","Walker",2004,64228,63478,750,1.18151170484262
"3433","Walker",2005,65160,64228,932,1.45108052562745
"3434","Walker",2006,66343,65160,1183,1.81553100061387
"3435","Walker",2007,67405,66343,1062,1.60077174683086
"3436","Walker",2008,68103,67405,698,1.03553148876196
"3437","Walker",2009,68612,68103,509,0.747397324640618
"3438","Walker",2010,68761,68612,149,0.217163178452749
"3439","Walker",2011,68848,68761,87,0.126525210511773
"3440","Walker",2012,68094,68848,-754,-1.09516616314199
"3441","Walker",2013,68198,68094,104,0.152730049637266
"3442","Walker",2014,68218,68198,20,0.0293263732074254
"3443","Walker",2015,68066,68218,-152,-0.222815092790759
"3444","Walker",2016,67896,68066,-170,-0.249757588223195
"3445","Walker",2017,68939,67896,1043,1.53617297042536
"3446","Walker",2018,69410,68939,471,0.683212695281336
"3447","Walker",2019,69761,69410,351,0.505690822648033
"3448","Walker",2020,70116,69761,355,0.508880319949542
"3449","Walker",2021,68510,70116,-1606,-2.29049004506817
"3450","Walker",2022,68915,68510,405,0.59115457597431
"3451","Walton",2000,61413,58160,3253,5.59319119669876
"3452","Walton",2001,63847,61413,2434,3.96333023952583
"3453","Walton",2002,66103,63847,2256,3.533447147086
"3454","Walton",2003,68161,66103,2058,3.11332314720966
"3455","Walton",2004,70334,68161,2173,3.18804008157157
"3456","Walton",2005,73696,70334,3362,4.780049478204
"3457","Walton",2006,77057,73696,3361,4.56062744246635
"3458","Walton",2007,80440,77057,3383,4.39025656332325
"3459","Walton",2008,82602,80440,2162,2.68771755345599
"3460","Walton",2009,83353,82602,751,0.909178954504734
"3461","Walton",2010,84004,83353,651,0.781015680299449
"3462","Walton",2011,84580,84004,576,0.685681634207895
"3463","Walton",2012,84575,84580,-5,-0.00591156301726176
"3464","Walton",2013,85754,84575,1179,1.39402896837127
"3465","Walton",2014,87615,85754,1861,2.17016115866315
"3466","Walton",2015,88399,87615,784,0.894823945671403
"3467","Walton",2016,90184,88399,1785,2.01925361146619
"3468","Walton",2017,91600,90184,1416,1.57012330346846
"3469","Walton",2018,93503,91600,1903,2.07751091703057
"3470","Walton",2019,94593,93503,1090,1.1657379977113
"3471","Walton",2020,96875,94593,2282,2.41244066685696
"3472","Walton",2021,99853,96875,2978,3.07406451612903
"3473","Walton",2022,103065,99853,3212,3.21672859102881
"3474","Ware",2000,35421,35570,-149,-0.418892324992972
"3475","Ware",2001,35426,35421,5,0.0141159199345021
"3476","Ware",2002,35203,35426,-223,-0.62948117202055
"3477","Ware",2003,35222,35203,19,0.0539726727835696
"3478","Ware",2004,34991,35222,-231,-0.655840099937539
"3479","Ware",2005,35011,34991,20,0.0571575547998057
"3480","Ware",2006,35624,35011,613,1.75087829539288
"3481","Ware",2007,36016,35624,392,1.10038176510218
"3482","Ware",2008,36065,36016,49,0.136050644158152
"3483","Ware",2009,35985,36065,-80,-0.221821710799945
"3484","Ware",2010,36340,35985,355,0.986522162011949
"3485","Ware",2011,36474,36340,134,0.368739680792515
"3486","Ware",2012,35821,36474,-653,-1.79031638975709
"3487","Ware",2013,35709,35821,-112,-0.312665754724882
"3488","Ware",2014,35515,35709,-194,-0.543280405500014
"3489","Ware",2015,35370,35515,-145,-0.408278192313107
"3490","Ware",2016,35738,35370,368,1.04042974271982
"3491","Ware",2017,35871,35738,133,0.372152890480721
"3492","Ware",2018,35680,35871,-191,-0.532463549942851
"3493","Ware",2019,35734,35680,54,0.151345291479821
"3494","Ware",2020,35826,35734,92,0.257457883248447
"3495","Ware",2021,36033,35826,207,0.577792664545302
"3496","Ware",2022,35614,36033,-419,-1.16282296783504
"3497","Warren",2000,6275,6375,-100,-1.56862745098039
"3498","Warren",2001,6356,6275,81,1.29083665338645
"3499","Warren",2002,6270,6356,-86,-1.3530522341095
"3500","Warren",2003,6229,6270,-41,-0.653907496012759
"3501","Warren",2004,6195,6229,-34,-0.545834002247552
"3502","Warren",2005,6153,6195,-42,-0.677966101694915
"3503","Warren",2006,6038,6153,-115,-1.86900698846091
"3504","Warren",2007,5981,6038,-57,-0.94402119907254
"3505","Warren",2008,5942,5981,-39,-0.652064872094967
"3506","Warren",2009,5914,5942,-28,-0.471221810838102
"3507","Warren",2010,5804,5914,-110,-1.85999323638823
"3508","Warren",2011,5721,5804,-83,-1.43004824259132
"3509","Warren",2012,5578,5721,-143,-2.49956301345919
"3510","Warren",2013,5558,5578,-20,-0.358551452133381
"3511","Warren",2014,5520,5558,-38,-0.68369917236416
"3512","Warren",2015,5460,5520,-60,-1.08695652173913
"3513","Warren",2016,5442,5460,-18,-0.32967032967033
"3514","Warren",2017,5303,5442,-139,-2.55420801176038
"3515","Warren",2018,5251,5303,-52,-0.980577031868753
"3516","Warren",2019,5254,5251,3,0.0571319748619311
"3517","Warren",2020,5232,5254,-22,-0.418728587742672
"3518","Warren",2021,5240,5232,8,0.152905198776758
"3519","Warren",2022,5155,5240,-85,-1.62213740458015
"3520","Washington",2000,21188,21026,162,0.770474650432798
"3521","Washington",2001,21170,21188,-18,-0.0849537474041911
"3522","Washington",2002,21000,21170,-170,-0.803023145961266
"3523","Washington",2003,21110,21000,110,0.523809523809524
"3524","Washington",2004,21088,21110,-22,-0.104216011369019
"3525","Washington",2005,20155,21088,-933,-4.42431714719272
"3526","Washington",2006,20805,20155,650,3.225006201935
"3527","Washington",2007,21155,20805,350,1.68228791155972
"3528","Washington",2008,21202,21155,47,0.222169699834554
"3529","Washington",2009,21240,21202,38,0.179228374681634
"3530","Washington",2010,21156,21240,-84,-0.395480225988701
"3531","Washington",2011,21111,21156,-45,-0.212705615428247
"3532","Washington",2012,20879,21111,-232,-1.09895315238501
"3533","Washington",2013,20676,20879,-203,-0.972268786819292
"3534","Washington",2014,20635,20676,-41,-0.198297543045076
"3535","Washington",2015,20816,20635,181,0.877150472498183
"3536","Washington",2016,20457,20816,-359,-1.72463489623367
"3537","Washington",2017,20313,20457,-144,-0.703915530136384
"3538","Washington",2018,20386,20313,73,0.359375769211835
"3539","Washington",2019,20374,20386,-12,-0.0588639262238791
"3540","Washington",2020,20150,20374,-224,-1.09944046333562
"3541","Washington",2021,19785,20150,-365,-1.81141439205955
"3542","Washington",2022,19738,19785,-47,-0.237553702299722
"3543","Wayne",2000,26596,26340,256,0.971905846621109
"3544","Wayne",2001,26888,26596,292,1.09790946006918
"3545","Wayne",2002,27308,26888,420,1.56203510859863
"3546","Wayne",2003,27860,27308,552,2.02138567452761
"3547","Wayne",2004,28227,27860,367,1.3173007896626
"3548","Wayne",2005,28522,28227,295,1.04509866439933
"3549","Wayne",2006,28929,28522,407,1.42696865577449
"3550","Wayne",2007,29421,28929,492,1.70071554495489
"3551","Wayne",2008,30042,29421,621,2.11073722851025
"3552","Wayne",2009,30016,30042,-26,-0.0865455029625191
"3553","Wayne",2010,30115,30016,99,0.329824093816631
"3554","Wayne",2011,30327,30115,212,0.70396812219824
"3555","Wayne",2012,30305,30327,-22,-0.0725426187885383
"3556","Wayne",2013,30077,30305,-228,-0.752351097178683
"3557","Wayne",2014,29949,30077,-128,-0.425574359144862
"3558","Wayne",2015,29534,29949,-415,-1.38568900464122
"3559","Wayne",2016,30104,29534,570,1.92997900724589
"3560","Wayne",2017,29817,30104,-287,-0.953361679511028
"3561","Wayne",2018,29808,29817,-9,-0.0301841231512225
"3562","Wayne",2019,29927,29808,119,0.39922168545357
"3563","Wayne",2020,30023,29927,96,0.32078056604404
"3564","Wayne",2021,30380,30023,357,1.18908836558638
"3565","Wayne",2022,30896,30380,516,1.69848584595128
"3566","Webster",2000,2398,2368,30,1.26689189189189
"3567","Webster",2001,2369,2398,-29,-1.209341117598
"3568","Webster",2002,2389,2369,20,0.844238075137189
"3569","Webster",2003,2488,2389,99,4.14399330263709
"3570","Webster",2004,2549,2488,61,2.45176848874598
"3571","Webster",2005,2576,2549,27,1.05923891722244
"3572","Webster",2006,2630,2576,54,2.09627329192547
"3573","Webster",2007,2735,2630,105,3.99239543726236
"3574","Webster",2008,2710,2735,-25,-0.914076782449726
"3575","Webster",2009,2772,2710,62,2.28782287822878
"3576","Webster",2010,2789,2772,17,0.613275613275613
"3577","Webster",2011,2791,2789,2,0.0717102904266762
"3578","Webster",2012,2793,2791,2,0.0716589036187746
"3579","Webster",2013,2719,2793,-74,-2.64948084496957
"3580","Webster",2014,2649,2719,-70,-2.57447591026113
"3581","Webster",2015,2648,2649,-1,-0.0377500943752359
"3582","Webster",2016,2599,2648,-49,-1.85045317220544
"3583","Webster",2017,2605,2599,6,0.230858022316276
"3584","Webster",2018,2611,2605,6,0.230326295585413
"3585","Webster",2019,2607,2611,-4,-0.15319800842589
"3586","Webster",2020,2595,2607,-12,-0.46029919447641
"3587","Webster",2021,2367,2595,-228,-8.78612716763006
"3588","Webster",2022,2328,2367,-39,-1.64765525982256
"3589","Wheeler",2000,6174,6111,63,1.03092783505155
"3590","Wheeler",2001,6697,6174,523,8.47100745059929
"3591","Wheeler",2002,6584,6697,-113,-1.68732268179782
"3592","Wheeler",2003,6576,6584,-8,-0.121506682867558
"3593","Wheeler",2004,6500,6576,-76,-1.15571776155718
"3594","Wheeler",2005,6701,6500,201,3.09230769230769
"3595","Wheeler",2006,6954,6701,253,3.77555588718102
"3596","Wheeler",2007,6918,6954,-36,-0.517687661777394
"3597","Wheeler",2008,7018,6918,100,1.44550448106389
"3598","Wheeler",2009,7150,7018,132,1.88087774294671
"3599","Wheeler",2010,7423,7150,273,3.81818181818182
"3600","Wheeler",2011,7939,7423,516,6.95136737168261
"3601","Wheeler",2012,7888,7939,-51,-0.642398286937901
"3602","Wheeler",2013,7909,7888,21,0.266227180527383
"3603","Wheeler",2014,7995,7909,86,1.08736882033127
"3604","Wheeler",2015,7903,7995,-92,-1.15071919949969
"3605","Wheeler",2016,7978,7903,75,0.949006706314058
"3606","Wheeler",2017,7952,7978,-26,-0.325896214590123
"3607","Wheeler",2018,7879,7952,-73,-0.918008048289738
"3608","Wheeler",2019,7855,7879,-24,-0.304607183652748
"3609","Wheeler",2020,7751,7855,-104,-1.32399745385105
"3610","Wheeler",2021,7471,7751,-280,-3.61243710488969
"3611","Wheeler",2022,7314,7471,-157,-2.10145897470218
"3612","White",2000,20186,19303,883,4.57441848417344
"3613","White",2001,21124,20186,938,4.64678490042604
"3614","White",2002,22281,21124,1157,5.47718235182731
"3615","White",2003,23178,22281,897,4.0258516224586
"3616","White",2004,24015,23178,837,3.6111830183795
"3617","White",2005,24690,24015,675,2.8107432854466
"3618","White",2006,25575,24690,885,3.58444714459295
"3619","White",2007,26173,25575,598,2.33822091886608
"3620","White",2008,26626,26173,453,1.73079127344974
"3621","White",2009,26949,26626,323,1.21309997746564
"3622","White",2010,27168,26949,219,0.8126461093176
"3623","White",2011,27273,27168,105,0.386484098939929
"3624","White",2012,27556,27273,283,1.03765629010377
"3625","White",2013,27797,27556,241,0.874582668021484
"3626","White",2014,27970,27797,173,0.622369320430262
"3627","White",2015,28319,27970,349,1.24776546299607
"3628","White",2016,28884,28319,565,1.99512694657297
"3629","White",2017,29453,28884,569,1.96994876055948
"3630","White",2018,29970,29453,517,1.75533901470139
"3631","White",2019,30798,29970,828,2.76276276276276
"3632","White",2020,31094,30798,296,0.961101370218845
"3633","White",2021,28442,31094,-2652,-8.52897665144401
"3634","White",2022,28806,28442,364,1.27979748259616
"3635","Whitfield",2000,84222,82505,1717,2.08108599478819
"3636","Whitfield",2001,86332,84222,2110,2.50528365510199
"3637","Whitfield",2002,88041,86332,1709,1.97956725200389
"3638","Whitfield",2003,89478,88041,1437,1.63219409138924
"3639","Whitfield",2004,91842,89478,2364,2.64199020988399
"3640","Whitfield",2005,94162,91842,2320,2.52607739378498
"3641","Whitfield",2006,96408,94162,2246,2.38525095048958
"3642","Whitfield",2007,98654,96408,2246,2.32968218405112
"3643","Whitfield",2008,100546,98654,1892,1.91781377338983
"3644","Whitfield",2009,101009,100546,463,0.46048574781692
"3645","Whitfield",2010,102934,101009,1925,1.90577077290142
"3646","Whitfield",2011,103184,102934,250,0.242874074649776
"3647","Whitfield",2012,103359,103184,175,0.16959993797488
"3648","Whitfield",2013,102945,103359,-414,-0.400545670913999
"3649","Whitfield",2014,103542,102945,597,0.579921317208218
"3650","Whitfield",2015,104216,103542,674,0.650943578451256
"3651","Whitfield",2016,104589,104216,373,0.357910493590236
"3652","Whitfield",2017,104658,104589,69,0.0659725210108138
"3653","Whitfield",2018,104062,104658,-596,-0.56947390548262
"3654","Whitfield",2019,104628,104062,566,0.543906517268551
"3655","Whitfield",2020,103837,104628,-791,-0.756011775050656
"3656","Whitfield",2021,102848,103837,-989,-0.952454327455531
"3657","Whitfield",2022,103132,102848,284,0.2761356565028
"3658","Wilcox",2000,8632,8515,117,1.37404580152672
"3659","Wilcox",2001,8868,8632,236,2.73401297497683
"3660","Wilcox",2002,8766,8868,-102,-1.15020297699594
"3661","Wilcox",2003,8837,8766,71,0.80994752452658
"3662","Wilcox",2004,8882,8837,45,0.509222586850741
"3663","Wilcox",2005,8789,8882,-93,-1.0470614726413
"3664","Wilcox",2006,8868,8789,79,0.898850836272614
"3665","Wilcox",2007,8889,8868,21,0.23680649526387
"3666","Wilcox",2008,9023,8889,134,1.50748115648554
"3667","Wilcox",2009,9156,9023,133,1.47401086113266
"3668","Wilcox",2010,9270,9156,114,1.24508519003932
"3669","Wilcox",2011,9298,9270,28,0.302049622437972
"3670","Wilcox",2012,9068,9298,-230,-2.47365024736502
"3671","Wilcox",2013,8960,9068,-108,-1.1910013233348
"3672","Wilcox",2014,8847,8960,-113,-1.26116071428571
"3673","Wilcox",2015,8857,8847,10,0.113032666440601
"3674","Wilcox",2016,8761,8857,-96,-1.08388844981371
"3675","Wilcox",2017,8800,8761,39,0.445154662709736
"3676","Wilcox",2018,8812,8800,12,0.136363636363636
"3677","Wilcox",2019,8635,8812,-177,-2.00862460281434
"3678","Wilcox",2020,8502,8635,-133,-1.54024319629415
"3679","Wilcox",2021,8739,8502,237,2.78757939308398
"3680","Wilcox",2022,8761,8739,22,0.251745050921158
"3681","Wilkes",2000,10694,10708,-14,-0.130743369443407
"3682","Wilkes",2001,10658,10694,-36,-0.336637366747709
"3683","Wilkes",2002,10695,10658,37,0.347157065115406
"3684","Wilkes",2003,10736,10695,41,0.383356708742403
"3685","Wilkes",2004,10613,10736,-123,-1.1456780923994
"3686","Wilkes",2005,10553,10613,-60,-0.56534438895694
"3687","Wilkes",2006,10586,10553,33,0.312707287027386
"3688","Wilkes",2007,10524,10586,-62,-0.585679198941999
"3689","Wilkes",2008,10630,10524,106,1.00722158874952
"3690","Wilkes",2009,10571,10630,-59,-0.555032925682032
"3691","Wilkes",2010,10590,10571,19,0.179737016365528
"3692","Wilkes",2011,10211,10590,-379,-3.57884796978281
"3693","Wilkes",2012,10076,10211,-135,-1.32210361374988
"3694","Wilkes",2013,10010,10076,-66,-0.655021834061135
"3695","Wilkes",2014,9940,10010,-70,-0.699300699300699
"3696","Wilkes",2015,9867,9940,-73,-0.734406438631791
"3697","Wilkes",2016,9805,9867,-62,-0.62835715009628
"3698","Wilkes",2017,9892,9805,87,0.887302396736359
"3699","Wilkes",2018,9876,9892,-16,-0.161746866154468
"3700","Wilkes",2019,9777,9876,-99,-1.00243013365735
"3701","Wilkes",2020,9694,9777,-83,-0.848931164979032
"3702","Wilkes",2021,9513,9694,-181,-1.8671343098824
"3703","Wilkes",2022,9599,9513,86,0.904026069588983
"3704","Wilkinson",2000,10193,10212,-19,-0.18605562083823
"3705","Wilkinson",2001,10227,10193,34,0.333562248601982
"3706","Wilkinson",2002,10126,10227,-101,-0.987581891072651
"3707","Wilkinson",2003,10040,10126,-86,-0.849298834682994
"3708","Wilkinson",2004,9968,10040,-72,-0.717131474103586
"3709","Wilkinson",2005,9881,9968,-87,-0.872792937399679
"3710","Wilkinson",2006,9793,9881,-88,-0.890598117599433
"3711","Wilkinson",2007,9750,9793,-43,-0.439089145307873
"3712","Wilkinson",2008,9691,9750,-59,-0.605128205128205
"3713","Wilkinson",2009,9652,9691,-39,-0.402435249200289
"3714","Wilkinson",2010,9540,9652,-112,-1.16038126813096
"3715","Wilkinson",2011,9444,9540,-96,-1.0062893081761
"3716","Wilkinson",2012,9577,9444,133,1.40830156713257
"3717","Wilkinson",2013,9432,9577,-145,-1.5140440639031
"3718","Wilkinson",2014,9326,9432,-106,-1.12383375742154
"3719","Wilkinson",2015,9155,9326,-171,-1.83358352991636
"3720","Wilkinson",2016,9104,9155,-51,-0.557072637902785
"3721","Wilkinson",2017,8959,9104,-145,-1.5927065026362
"3722","Wilkinson",2018,9036,8959,77,0.859470923094095
"3723","Wilkinson",2019,8954,9036,-82,-0.907481186365649
"3724","Wilkinson",2020,8812,8954,-142,-1.58588340406522
"3725","Wilkinson",2021,8831,8812,19,0.215615070358602
"3726","Wilkinson",2022,8681,8831,-150,-1.69856188427132
"3727","Worth",2000,21983,22067,-84,-0.380658902433498
"3728","Worth",2001,22019,21983,36,0.163762907701406
"3729","Worth",2002,21873,22019,-146,-0.663063717698351
"3730","Worth",2003,21874,21873,1,0.00457184656882915
"3731","Worth",2004,21873,21874,-1,-0.0045716375605742
"3732","Worth",2005,21670,21873,-203,-0.928084853472318
"3733","Worth",2006,21783,21670,113,0.521458237194278
"3734","Worth",2007,21646,21783,-137,-0.628930817610063
"3735","Worth",2008,21701,21646,55,0.254088515199113
"3736","Worth",2009,21799,21701,98,0.451592092530298
"3737","Worth",2010,21630,21799,-169,-0.775264920409193
"3738","Worth",2011,21921,21630,291,1.34535367545076
"3739","Worth",2012,21741,21921,-180,-0.821130422882168
"3740","Worth",2013,21291,21741,-450,-2.0698219953084
"3741","Worth",2014,20940,21291,-351,-1.64858390869381
"3742","Worth",2015,20699,20940,-241,-1.15090735434575
"3743","Worth",2016,20748,20699,49,0.236726411903957
"3744","Worth",2017,20533,20748,-215,-1.03624445729709
"3745","Worth",2018,20299,20533,-234,-1.13962889007938
"3746","Worth",2019,20247,20299,-52,-0.256170254692349
"3747","Worth",2020,19972,20247,-275,-1.35822591001136
"3748","Worth",2021,20554,19972,582,2.91407971159623
"3749","Worth",2022,20424,20554,-130,-0.632480295806169
